CreateText|Reference/Text/CreateText.htm
CreateText|Reference/Text/CreateText.htm
DeleteAllText|Reference/Text/DeleteAllText.htm
DeleteText|Reference/Text/DeleteText.htm
CreateMemblockFromSound|Reference/Memblock/CreateMemblockFromSound.htm
CreateMemblockFromSound|Reference/Memblock/CreateMemblockFromSound.htm
CreateMusicFromOGGMemblock|Reference/Memblock/CreateMusicFromOGGMemblock.htm
CreateMusicFromOGGMemblock|Reference/Memblock/CreateMusicFromOGGMemblock.htm
CreateSoundFromMemblock|Reference/Memblock/CreateSoundFromMemblock.htm
CreateSoundFromMemblock|Reference/Memblock/CreateSoundFromMemblock.htm
CreateSoundFromOGGMemblock|Reference/Memblock/CreateSoundFromOGGMemblock.htm
CreateSoundFromOGGMemblock|Reference/Memblock/CreateSoundFromOGGMemblock.htm
DeleteFont|Reference/Font/DeleteFont.htm
GetFontExists|Reference/Font/GetFontExists.htm
GetSystemFontExists|Reference/Font/GetSystemFontExists.htm
LoadFont|Reference/Font/LoadFont.htm
LoadFont|Reference/Font/LoadFont.htm
CreateAdvert|Reference/Advert/CreateAdvert.htm
CreateAdvertEx|Reference/Advert/CreateAdvertEx.htm
CreateFullscreenAdvert|Reference/Advert/CreateFullscreenAdvert.htm
DeleteAdvert|Reference/Advert/DeleteAdvert.htm
RequestAdvertRefresh|Reference/Advert/RequestAdvertRefresh.htm
SetAdvertLocation|Reference/Advert/SetAdvertLocation.htm
SetAdvertLocationEx|Reference/Advert/SetAdvertLocationEx.htm
SetAdvertPosition|Reference/Advert/SetAdvertPosition.htm
SetAdvertVisible|Reference/Advert/SetAdvertVisible.htm
GetSpeechNumVoices|Reference/Sound/GetSpeechNumVoices.htm
GetSpeechVoiceID|Reference/Sound/GetSpeechVoiceID.htm
GetSpeechVoiceLanguage|Reference/Sound/GetSpeechVoiceLanguage.htm
GetSpeechVoiceName|Reference/Sound/GetSpeechVoiceName.htm
GetTextToSpeechReady|Reference/Sound/GetTextToSpeechReady.htm
IsSpeaking|Reference/Sound/IsSpeaking.htm
SetSpeechLanguage|Reference/Sound/SetSpeechLanguage.htm
SetSpeechLanguageByID|Reference/Sound/SetSpeechLanguageByID.htm
SetSpeechRate|Reference/Sound/SetSpeechRate.htm
Speak|Reference/Sound/Speak.htm
Speak|Reference/Sound/Speak.htm
StopSpeaking|Reference/Sound/StopSpeaking.htm
TextToSpeechSetup|Reference/Sound/TextToSpeechSetup.htm
SetSoundDeviceMode|Reference/Sound/SetSoundDeviceMode.htm
HTTPDecode|Reference/HTTP/HTTPDecode.htm
HTTPEncode|Reference/HTTP/HTTPEncode.htm
GetObjectBoneAngleX|Reference/3D/GetObjectBoneAngleX.htm
GetObjectBoneAngleY|Reference/3D/GetObjectBoneAngleY.htm
GetObjectBoneAngleZ|Reference/3D/GetObjectBoneAngleZ.htm
GetObjectBoneByName|Reference/3D/GetObjectBoneByName.htm
GetObjectBoneName|Reference/3D/GetObjectBoneName.htm
GetObjectBoneQuatW|Reference/3D/GetObjectBoneQuatW.htm
GetObjectBoneQuatX|Reference/3D/GetObjectBoneQuatX.htm
GetObjectBoneQuatY|Reference/3D/GetObjectBoneQuatY.htm
GetObjectBoneQuatZ|Reference/3D/GetObjectBoneQuatZ.htm
GetObjectBoneWorldAngleX|Reference/3D/GetObjectBoneWorldAngleX.htm
GetObjectBoneWorldAngleY|Reference/3D/GetObjectBoneWorldAngleY.htm
GetObjectBoneWorldAngleZ|Reference/3D/GetObjectBoneWorldAngleZ.htm
GetObjectBoneWorldQuatW|Reference/3D/GetObjectBoneWorldQuatW.htm
GetObjectBoneWorldQuatX|Reference/3D/GetObjectBoneWorldQuatX.htm
GetObjectBoneWorldQuatY|Reference/3D/GetObjectBoneWorldQuatY.htm
GetObjectBoneWorldQuatZ|Reference/3D/GetObjectBoneWorldQuatZ.htm
GetObjectBoneWorldX|Reference/3D/GetObjectBoneWorldX.htm
GetObjectBoneWorldY|Reference/3D/GetObjectBoneWorldY.htm
GetObjectBoneWorldZ|Reference/3D/GetObjectBoneWorldZ.htm
GetObjectBoneX|Reference/3D/GetObjectBoneX.htm
GetObjectBoneY|Reference/3D/GetObjectBoneY.htm
GetObjectBoneZ|Reference/3D/GetObjectBoneZ.htm
GetObjectNumBones|Reference/3D/GetObjectNumBones.htm
RotateObjectBoneLocalX|Reference/3D/RotateObjectBoneLocalX.htm
RotateObjectBoneLocalY|Reference/3D/RotateObjectBoneLocalY.htm
RotateObjectBoneLocalZ|Reference/3D/RotateObjectBoneLocalZ.htm
SetObjectBoneCanAnimate|Reference/3D/SetObjectBoneCanAnimate.htm
SetObjectBoneLookAt|Reference/3D/SetObjectBoneLookAt.htm
SetObjectBonePosition|Reference/3D/SetObjectBonePosition.htm
SetObjectBoneRotation|Reference/3D/SetObjectBoneRotation.htm
SetObjectBoneRotationQuat|Reference/3D/SetObjectBoneRotationQuat.htm
AddZipEntry|Reference/File/AddZipEntry.htm
CancelZipExtract|Reference/File/CancelZipExtract.htm
CloseZip|Reference/File/CloseZip.htm
CreateZip|Reference/File/CreateZip.htm
CreateZip|Reference/File/CreateZip.htm
ExtractZip|Reference/File/ExtractZip.htm
ExtractZip|Reference/File/ExtractZip.htm
ExtractZipASync|Reference/File/ExtractZipASync.htm
GetZipExtractComplete|Reference/File/GetZipExtractComplete.htm
GetZipExtractProgress|Reference/File/GetZipExtractProgress.htm
AddObjectShapeBox|Reference/3DPhysics/AddObjectShapeBox.htm
AddObjectShapeCapsule|Reference/3DPhysics/AddObjectShapeCapsule.htm
AddObjectShapeCone|Reference/3DPhysics/AddObjectShapeCone.htm
AddObjectShapeCylinder|Reference/3DPhysics/AddObjectShapeCylinder.htm
AddObjectShapeSphere|Reference/3DPhysics/AddObjectShapeSphere.htm
ClearDepthBuffer|Reference/Core/ClearDepthBuffer.htm
ClearScreen|Reference/Core/ClearScreen.htm
EnableClearColor|Reference/Core/EnableClearColor.htm
EnableClearDepth|Reference/Core/EnableClearDepth.htm
GetDeviceDPI|Reference/Core/GetDeviceDPI.htm
GetDeviceHeight|Reference/Core/GetDeviceHeight.htm
GetDeviceWidth|Reference/Core/GetDeviceWidth.htm
GetDisplayAspect|Reference/Core/GetDisplayAspect.htm
GetMaxDeviceHeight|Reference/Core/GetMaxDeviceHeight.htm
GetMaxDeviceWidth|Reference/Core/GetMaxDeviceWidth.htm
GetOrientation|Reference/Core/GetOrientation.htm
GetPaused|Reference/Core/GetPaused.htm
GetPolygonsDrawn|Reference/Core/GetPolygonsDrawn.htm
GetRendererName|Reference/Core/GetRendererName.htm
GetResumed|Reference/Core/GetResumed.htm
GetScreenBoundsBottom|Reference/Core/GetScreenBoundsBottom.htm
GetScreenBoundsLeft|Reference/Core/GetScreenBoundsLeft.htm
GetScreenBoundsRight|Reference/Core/GetScreenBoundsRight.htm
GetScreenBoundsTop|Reference/Core/GetScreenBoundsTop.htm
GetShadowPolygonsDrawn|Reference/Core/GetShadowPolygonsDrawn.htm
GetVerticesProcessed|Reference/Core/GetVerticesProcessed.htm
GetViewOffsetX|Reference/Core/GetViewOffsetX.htm
GetViewOffsetY|Reference/Core/GetViewOffsetY.htm
GetViewZoom|Reference/Core/GetViewZoom.htm
GetVirtualHeight|Reference/Core/GetVirtualHeight.htm
GetVirtualWidth|Reference/Core/GetVirtualWidth.htm
GetWindowHeight|Reference/Core/GetWindowHeight.htm
GetWindowWidth|Reference/Core/GetWindowWidth.htm
IsSupportedDepthTexture|Reference/Core/IsSupportedDepthTexture.htm
MaximizeWindow|Reference/Core/MaximizeWindow.htm
MinimizeApp|Reference/Core/MinimizeApp.htm
Render|Reference/Core/Render.htm
Render2DBack|Reference/Core/Render2DBack.htm
Render2DFront|Reference/Core/Render2DFront.htm
Render3D|Reference/Core/Render3D.htm
RenderShadowMap|Reference/Core/RenderShadowMap.htm
RestoreApp|Reference/Core/RestoreApp.htm
ScreenFPS|Reference/Core/ScreenFPS.htm
ScreenToWorldX|Reference/Core/ScreenToWorldX.htm
ScreenToWorldY|Reference/Core/ScreenToWorldY.htm
SetBorderColor|Reference/Core/SetBorderColor.htm
SetClearColor|Reference/Core/SetClearColor.htm
SetDisplayAspect|Reference/Core/SetDisplayAspect.htm
SetImmersiveMode|Reference/Core/SetImmersiveMode.htm
SetIntendedDeviceSize|Reference/Core/SetIntendedDeviceSize.htm
SetOrientationAllowed|Reference/Core/SetOrientationAllowed.htm
SetRenderToImage|Reference/Core/SetRenderToImage.htm
SetRenderToScreen|Reference/Core/SetRenderToScreen.htm
SetResolutionMode|Reference/Core/SetResolutionMode.htm
SetScissor|Reference/Core/SetScissor.htm
SetScreenResolution|Reference/Core/SetScreenResolution.htm
SetSyncRate|Reference/Core/SetSyncRate.htm
SetTransitionMode|Reference/Core/SetTransitionMode.htm
SetVSync|Reference/Core/SetVSync.htm
SetViewOffset|Reference/Core/SetViewOffset.htm
SetViewZoom|Reference/Core/SetViewZoom.htm
SetViewZoomMode|Reference/Core/SetViewZoomMode.htm
SetVirtualResolution|Reference/Core/SetVirtualResolution.htm
SetWindowAllowResize|Reference/Core/SetWindowAllowResize.htm
SetWindowPosition|Reference/Core/SetWindowPosition.htm
SetWindowSize|Reference/Core/SetWindowSize.htm
SetWindowSize|Reference/Core/SetWindowSize.htm
Swap|Reference/Core/Swap.htm
Sync|Reference/Core/Sync.htm
UpdateDeviceSize|Reference/Core/UpdateDeviceSize.htm
WorldToScreenX|Reference/Core/WorldToScreenX.htm
WorldToScreenY|Reference/Core/WorldToScreenY.htm
GetPointerPressed|Reference/Input/GetPointerPressed.htm
GetPointerReleased|Reference/Input/GetPointerReleased.htm
GetPointerState|Reference/Input/GetPointerState.htm
GetPointerX|Reference/Input/GetPointerX.htm
GetPointerY|Reference/Input/GetPointerY.htm
CopyMemblock|Reference/Memblock/CopyMemblock.htm
CreateMemblock|Reference/Memblock/CreateMemblock.htm
CreateMemblock|Reference/Memblock/CreateMemblock.htm
DeleteMemblock|Reference/Memblock/DeleteMemblock.htm
GetMemblockByte|Reference/Memblock/GetMemblockByte.htm
GetMemblockByteSigned|Reference/Memblock/GetMemblockByteSigned.htm
GetMemblockExists|Reference/Memblock/GetMemblockExists.htm
GetMemblockFloat|Reference/Memblock/GetMemblockFloat.htm
GetMemblockInt|Reference/Memblock/GetMemblockInt.htm
GetMemblockSHA1|Reference/Memblock/GetMemblockSHA1.htm
GetMemblockSHA256|Reference/Memblock/GetMemblockSHA256.htm
GetMemblockShort|Reference/Memblock/GetMemblockShort.htm
GetMemblockSize|Reference/Memblock/GetMemblockSize.htm
GetMemblockString|Reference/Memblock/GetMemblockString.htm
SetMemblockByte|Reference/Memblock/SetMemblockByte.htm
SetMemblockByteSigned|Reference/Memblock/SetMemblockByteSigned.htm
SetMemblockFloat|Reference/Memblock/SetMemblockFloat.htm
SetMemblockInt|Reference/Memblock/SetMemblockInt.htm
SetMemblockShort|Reference/Memblock/SetMemblockShort.htm
SetMemblockString|Reference/Memblock/SetMemblockString.htm
SetInneractiveDetails|Reference/Advert/SetInneractiveDetails.htm
DeleteSound|Reference/Sound/DeleteSound.htm
LoadSound|Reference/Sound/LoadSound.htm
LoadSound|Reference/Sound/LoadSound.htm
LoadSoundOGG|Reference/Sound/LoadSoundOGG.htm
LoadSoundOGG|Reference/Sound/LoadSoundOGG.htm
PlaySound|Reference/Sound/PlaySound.htm
PlaySound|Reference/Sound/PlaySound.htm
PlaySound|Reference/Sound/PlaySound.htm
PlaySound|Reference/Sound/PlaySound.htm
SaveSound|Reference/Sound/SaveSound.htm
StopSound|Reference/Sound/StopSound.htm
Asc|Reference/Core/Asc.htm
Bin|Reference/Core/Bin.htm
ByteLen|Reference/Core/ByteLen.htm
Chr|Reference/Core/Chr.htm
CompareString|Reference/Core/CompareString.htm
CompareString|Reference/Core/CompareString.htm
CountStringTokens|Reference/Core/CountStringTokens.htm
CountStringTokens2|Reference/Core/CountStringTokens2.htm
FindString|Reference/Core/FindString.htm
FindString|Reference/Core/FindString.htm
FindStringCount|Reference/Core/FindStringCount.htm
FindStringCount|Reference/Core/FindStringCount.htm
FindStringReverse|Reference/Core/FindStringReverse.htm
FindStringReverse|Reference/Core/FindStringReverse.htm
GetStringToken|Reference/Core/GetStringToken.htm
GetStringToken2|Reference/Core/GetStringToken2.htm
Hex|Reference/Core/Hex.htm
HexToBase64|Reference/Core/HexToBase64.htm
Left|Reference/Core/Left.htm
Len|Reference/Core/Len.htm
Lower|Reference/Core/Lower.htm
Mid|Reference/Core/Mid.htm
ReplaceString|Reference/Core/ReplaceString.htm
Right|Reference/Core/Right.htm
Spaces|Reference/Core/Spaces.htm
Str|Reference/Core/Str.htm
Str|Reference/Core/Str.htm
Str|Reference/Core/Str.htm
StringToBase64|Reference/Core/StringToBase64.htm
StripString|Reference/Core/StripString.htm
TrimString|Reference/Core/TrimString.htm
TruncateString|Reference/Core/TruncateString.htm
Upper|Reference/Core/Upper.htm
Val|Reference/Core/Val.htm
Val|Reference/Core/Val.htm
ValFloat|Reference/Core/ValFloat.htm
CheckPermission|Reference/Extras/CheckPermission.htm
RequestPermission|Reference/Extras/RequestPermission.htm
CreateFileFromMemblock|Reference/Memblock/CreateFileFromMemblock.htm
CreateMemblockFromFile|Reference/Memblock/CreateMemblockFromFile.htm
CreateMemblockFromFile|Reference/Memblock/CreateMemblockFromFile.htm
GameCenterAchievementsReset|Reference/Extras/GameCenterAchievementsReset.htm
GameCenterAchievementsShow|Reference/Extras/GameCenterAchievementsShow.htm
GameCenterLogin|Reference/Extras/GameCenterLogin.htm
GameCenterLogout|Reference/Extras/GameCenterLogout.htm
GameCenterSetup|Reference/Extras/GameCenterSetup.htm
GameCenterShowLeaderBoard|Reference/Extras/GameCenterShowLeaderBoard.htm
GameCenterSubmitAchievement|Reference/Extras/GameCenterSubmitAchievement.htm
GameCenterSubmitScore|Reference/Extras/GameCenterSubmitScore.htm
GetGameCenterExists|Reference/Extras/GetGameCenterExists.htm
GetGameCenterLoggedIn|Reference/Extras/GetGameCenterLoggedIn.htm
GetGameCenterPlayerDisplayName|Reference/Extras/GetGameCenterPlayerDisplayName.htm
GetGameCenterPlayerID|Reference/Extras/GetGameCenterPlayerID.htm
DrawText|Reference/Text/DrawText.htm
FixTextToScreen|Reference/Text/FixTextToScreen.htm
GetTextAlignment|Reference/Text/GetTextAlignment.htm
GetTextCharAngle|Reference/Text/GetTextCharAngle.htm
GetTextCharAngleRad|Reference/Text/GetTextCharAngleRad.htm
GetTextCharColorAlpha|Reference/Text/GetTextCharColorAlpha.htm
GetTextCharColorBlue|Reference/Text/GetTextCharColorBlue.htm
GetTextCharColorGreen|Reference/Text/GetTextCharColorGreen.htm
GetTextCharColorRed|Reference/Text/GetTextCharColorRed.htm
GetTextCharX|Reference/Text/GetTextCharX.htm
GetTextCharY|Reference/Text/GetTextCharY.htm
GetTextColorAlpha|Reference/Text/GetTextColorAlpha.htm
GetTextColorBlue|Reference/Text/GetTextColorBlue.htm
GetTextColorGreen|Reference/Text/GetTextColorGreen.htm
GetTextColorRed|Reference/Text/GetTextColorRed.htm
GetTextDepth|Reference/Text/GetTextDepth.htm
GetTextExists|Reference/Text/GetTextExists.htm
GetTextHitTest|Reference/Text/GetTextHitTest.htm
GetTextLength|Reference/Text/GetTextLength.htm
GetTextLineSpacing|Reference/Text/GetTextLineSpacing.htm
GetTextSize|Reference/Text/GetTextSize.htm
GetTextSpacing|Reference/Text/GetTextSpacing.htm
GetTextString|Reference/Text/GetTextString.htm
GetTextTotalHeight|Reference/Text/GetTextTotalHeight.htm
GetTextTotalWidth|Reference/Text/GetTextTotalWidth.htm
GetTextVisible|Reference/Text/GetTextVisible.htm
GetTextX|Reference/Text/GetTextX.htm
GetTextY|Reference/Text/GetTextY.htm
SetTextAlignment|Reference/Text/SetTextAlignment.htm
SetTextAngle|Reference/Text/SetTextAngle.htm
SetTextAngleRad|Reference/Text/SetTextAngleRad.htm
SetTextBold|Reference/Text/SetTextBold.htm
SetTextCharAngle|Reference/Text/SetTextCharAngle.htm
SetTextCharAngleRad|Reference/Text/SetTextCharAngleRad.htm
SetTextCharBold|Reference/Text/SetTextCharBold.htm
SetTextCharColor|Reference/Text/SetTextCharColor.htm
SetTextCharColorAlpha|Reference/Text/SetTextCharColorAlpha.htm
SetTextCharColorBlue|Reference/Text/SetTextCharColorBlue.htm
SetTextCharColorGreen|Reference/Text/SetTextCharColorGreen.htm
SetTextCharColorRed|Reference/Text/SetTextCharColorRed.htm
SetTextCharPosition|Reference/Text/SetTextCharPosition.htm
SetTextCharX|Reference/Text/SetTextCharX.htm
SetTextCharY|Reference/Text/SetTextCharY.htm
SetTextColor|Reference/Text/SetTextColor.htm
SetTextColorAlpha|Reference/Text/SetTextColorAlpha.htm
SetTextColorBlue|Reference/Text/SetTextColorBlue.htm
SetTextColorGreen|Reference/Text/SetTextColorGreen.htm
SetTextColorRed|Reference/Text/SetTextColorRed.htm
SetTextDefaultExtendedFontImage|Reference/Text/SetTextDefaultExtendedFontImage.htm
SetTextDefaultFontImage|Reference/Text/SetTextDefaultFontImage.htm
SetTextDefaultMagFilter|Reference/Text/SetTextDefaultMagFilter.htm
SetTextDefaultMinFilter|Reference/Text/SetTextDefaultMinFilter.htm
SetTextDepth|Reference/Text/SetTextDepth.htm
SetTextExtendedFontImage|Reference/Text/SetTextExtendedFontImage.htm
SetTextFont|Reference/Text/SetTextFont.htm
SetTextFontImage|Reference/Text/SetTextFontImage.htm
SetTextLineSpacing|Reference/Text/SetTextLineSpacing.htm
SetTextMaxWidth|Reference/Text/SetTextMaxWidth.htm
SetTextPosition|Reference/Text/SetTextPosition.htm
SetTextScissor|Reference/Text/SetTextScissor.htm
SetTextSize|Reference/Text/SetTextSize.htm
SetTextSpacing|Reference/Text/SetTextSpacing.htm
SetTextString|Reference/Text/SetTextString.htm
SetTextTransparency|Reference/Text/SetTextTransparency.htm
SetTextVisible|Reference/Text/SetTextVisible.htm
SetTextX|Reference/Text/SetTextX.htm
SetTextY|Reference/Text/SetTextY.htm
UseNewDefaultFonts|Reference/Text/UseNewDefaultFonts.htm
FileEOF|Reference/File/FileEOF.htm
OpenToRead|Reference/File/OpenToRead.htm
OpenToRead|Reference/File/OpenToRead.htm
ReadByte|Reference/File/ReadByte.htm
ReadFloat|Reference/File/ReadFloat.htm
ReadInteger|Reference/File/ReadInteger.htm
ReadLine|Reference/File/ReadLine.htm
ReadString|Reference/File/ReadString.htm
ReadString2|Reference/File/ReadString2.htm
GetRawFirstTouchEvent|Reference/Input-Raw/GetRawFirstTouchEvent.htm
GetRawNextTouchEvent|Reference/Input-Raw/GetRawNextTouchEvent.htm
GetRawTouchCount|Reference/Input-Raw/GetRawTouchCount.htm
GetRawTouchCurrentX|Reference/Input-Raw/GetRawTouchCurrentX.htm
GetRawTouchCurrentY|Reference/Input-Raw/GetRawTouchCurrentY.htm
GetRawTouchLastX|Reference/Input-Raw/GetRawTouchLastX.htm
GetRawTouchLastY|Reference/Input-Raw/GetRawTouchLastY.htm
GetRawTouchReleased|Reference/Input-Raw/GetRawTouchReleased.htm
GetRawTouchStartX|Reference/Input-Raw/GetRawTouchStartX.htm
GetRawTouchStartY|Reference/Input-Raw/GetRawTouchStartY.htm
GetRawTouchTime|Reference/Input-Raw/GetRawTouchTime.htm
GetRawTouchType|Reference/Input-Raw/GetRawTouchType.htm
GetRawTouchValue|Reference/Input-Raw/GetRawTouchValue.htm
SetRawTouchMoveSensitivity|Reference/Input-Raw/SetRawTouchMoveSensitivity.htm
SetRawTouchValue|Reference/Input-Raw/SetRawTouchValue.htm
SetSkyBoxHorizonColor|Reference/3D/SetSkyBoxHorizonColor.htm
SetSkyBoxHorizonSize|Reference/3D/SetSkyBoxHorizonSize.htm
SetSkyBoxSkyColor|Reference/3D/SetSkyBoxSkyColor.htm
SetSkyBoxSunColor|Reference/3D/SetSkyBoxSunColor.htm
SetSkyBoxSunSize|Reference/3D/SetSkyBoxSunSize.htm
SetSkyBoxSunVisible|Reference/3D/SetSkyBoxSunVisible.htm
SetSkyBoxVisible|Reference/3D/SetSkyBoxVisible.htm
AddSpriteAnimationFrame|Reference/Sprite/AddSpriteAnimationFrame.htm
ClearSpriteAnimationFrames|Reference/Sprite/ClearSpriteAnimationFrames.htm
GetSpriteCurrentFrame|Reference/Sprite/GetSpriteCurrentFrame.htm
GetSpriteFrameCount|Reference/Sprite/GetSpriteFrameCount.htm
GetSpritePlaying|Reference/Sprite/GetSpritePlaying.htm
PlaySprite|Reference/Sprite/PlaySprite.htm
PlaySprite|Reference/Sprite/PlaySprite.htm
PlaySprite|Reference/Sprite/PlaySprite.htm
PlaySprite|Reference/Sprite/PlaySprite.htm
ResumeSprite|Reference/Sprite/ResumeSprite.htm
SetSpriteAnimation|Reference/Sprite/SetSpriteAnimation.htm
SetSpriteFrame|Reference/Sprite/SetSpriteFrame.htm
SetSpriteSpeed|Reference/Sprite/SetSpriteSpeed.htm
StopSprite|Reference/Sprite/StopSprite.htm
CreateSkeleton2D|Reference/Skeleton/CreateSkeleton2D.htm
CreateSkeleton2D|Reference/Skeleton/CreateSkeleton2D.htm
DeleteSkeleton2D|Reference/Skeleton/DeleteSkeleton2D.htm
FixSkeleton2DToScreen|Reference/Skeleton/FixSkeleton2DToScreen.htm
FixSpriteToSkeleton2D|Reference/Skeleton/FixSpriteToSkeleton2D.htm
GetSkeleton2DAngle|Reference/Skeleton/GetSkeleton2DAngle.htm
GetSkeleton2DAnimationTime|Reference/Skeleton/GetSkeleton2DAnimationTime.htm
GetSkeleton2DBone|Reference/Skeleton/GetSkeleton2DBone.htm
GetSkeleton2DBoneAngle|Reference/Skeleton/GetSkeleton2DBoneAngle.htm
GetSkeleton2DBoneCurrAngle|Reference/Skeleton/GetSkeleton2DBoneCurrAngle.htm
GetSkeleton2DBoneCurrX|Reference/Skeleton/GetSkeleton2DBoneCurrX.htm
GetSkeleton2DBoneCurrY|Reference/Skeleton/GetSkeleton2DBoneCurrY.htm
GetSkeleton2DBoneParent|Reference/Skeleton/GetSkeleton2DBoneParent.htm
GetSkeleton2DBoneX|Reference/Skeleton/GetSkeleton2DBoneX.htm
GetSkeleton2DBoneY|Reference/Skeleton/GetSkeleton2DBoneY.htm
GetSkeleton2DCurrentTime|Reference/Skeleton/GetSkeleton2DCurrentTime.htm
GetSkeleton2DDepth|Reference/Skeleton/GetSkeleton2DDepth.htm
GetSkeleton2DExists|Reference/Skeleton/GetSkeleton2DExists.htm
GetSkeleton2DIsAnimating|Reference/Skeleton/GetSkeleton2DIsAnimating.htm
GetSkeleton2DIsTweening|Reference/Skeleton/GetSkeleton2DIsTweening.htm
GetSkeleton2DX|Reference/Skeleton/GetSkeleton2DX.htm
GetSkeleton2DY|Reference/Skeleton/GetSkeleton2DY.htm
LoadSkeleton2DFromSpineFile|Reference/Skeleton/LoadSkeleton2DFromSpineFile.htm
LoadSkeleton2DFromSpineFile|Reference/Skeleton/LoadSkeleton2DFromSpineFile.htm
LoadSkeleton2DFromSpriterFile|Reference/Skeleton/LoadSkeleton2DFromSpriterFile.htm
LoadSkeleton2DFromSpriterFile|Reference/Skeleton/LoadSkeleton2DFromSpriterFile.htm
PlaySkeleton2DAnimation|Reference/Skeleton/PlaySkeleton2DAnimation.htm
SetSkeleton2DAnimationFrame|Reference/Skeleton/SetSkeleton2DAnimationFrame.htm
SetSkeleton2DAnimationSpeed|Reference/Skeleton/SetSkeleton2DAnimationSpeed.htm
SetSkeleton2DBoneAngle|Reference/Skeleton/SetSkeleton2DBoneAngle.htm
SetSkeleton2DBoneMode|Reference/Skeleton/SetSkeleton2DBoneMode.htm
SetSkeleton2DBonePosition|Reference/Skeleton/SetSkeleton2DBonePosition.htm
SetSkeleton2DBoneScale|Reference/Skeleton/SetSkeleton2DBoneScale.htm
SetSkeleton2DDepth|Reference/Skeleton/SetSkeleton2DDepth.htm
SetSkeleton2DFlip|Reference/Skeleton/SetSkeleton2DFlip.htm
SetSkeleton2DPosition|Reference/Skeleton/SetSkeleton2DPosition.htm
SetSkeleton2DRotation|Reference/Skeleton/SetSkeleton2DRotation.htm
SetSkeleton2DVisible|Reference/Skeleton/SetSkeleton2DVisible.htm
StopSkeleton2DAnimation|Reference/Skeleton/StopSkeleton2DAnimation.htm
CopyImage|Reference/Image/CopyImage.htm
CopyImage|Reference/Image/CopyImage.htm
CreateImageColor|Reference/Image/CreateImageColor.htm
CreateImageColor|Reference/Image/CreateImageColor.htm
CreateRenderImage|Reference/Image/CreateRenderImage.htm
CreateRenderImage|Reference/Image/CreateRenderImage.htm
DeleteAllImages|Reference/Image/DeleteAllImages.htm
DeleteImage|Reference/Image/DeleteImage.htm
GetImage|Reference/Image/GetImage.htm
GetImage|Reference/Image/GetImage.htm
GetImageExists|Reference/Image/GetImageExists.htm
GetImageSizeFromFile|Reference/Image/GetImageSizeFromFile.htm
LoadImage|Reference/Image/LoadImage.htm
LoadImage|Reference/Image/LoadImage.htm
LoadImage|Reference/Image/LoadImage.htm
LoadImage|Reference/Image/LoadImage.htm
LoadImageResized|Reference/Image/LoadImageResized.htm
LoadImageResized|Reference/Image/LoadImageResized.htm
LoadSubImage|Reference/Image/LoadSubImage.htm
LoadSubImage|Reference/Image/LoadSubImage.htm
PrintImage|Reference/Image/PrintImage.htm
SaveImage|Reference/Image/SaveImage.htm
SetImageSubImages|Reference/Image/SetImageSubImages.htm
CreateUDPListener|Reference/Multiplayer/CreateUDPListener.htm
CreateUDPListener|Reference/Multiplayer/CreateUDPListener.htm
DeleteUDPListener|Reference/Multiplayer/DeleteUDPListener.htm
GetUDPNetworkMessage|Reference/Multiplayer/GetUDPNetworkMessage.htm
SendUDPNetworkMessage|Reference/Multiplayer/SendUDPNetworkMessage.htm
GetDrawingSetupTime|Reference/Benchmarking/GetDrawingSetupTime.htm
GetDrawingTime|Reference/Benchmarking/GetDrawingTime.htm
GetImageMemoryUsage|Reference/Benchmarking/GetImageMemoryUsage.htm
GetLoadedImages|Reference/Benchmarking/GetLoadedImages.htm
GetManagedSpriteCount|Reference/Benchmarking/GetManagedSpriteCount.htm
GetManagedSpriteDrawCalls|Reference/Benchmarking/GetManagedSpriteDrawCalls.htm
GetManagedSpriteDrawnCount|Reference/Benchmarking/GetManagedSpriteDrawnCount.htm
GetManagedSpriteSortedCount|Reference/Benchmarking/GetManagedSpriteSortedCount.htm
GetParticleDrawnPointCount|Reference/Benchmarking/GetParticleDrawnPointCount.htm
GetParticleDrawnQuadCount|Reference/Benchmarking/GetParticleDrawnQuadCount.htm
GetPhysicsTime|Reference/Benchmarking/GetPhysicsTime.htm
GetPixelsDrawn|Reference/Benchmarking/GetPixelsDrawn.htm
GetUnassignedImageFileName|Reference/Benchmarking/GetUnassignedImageFileName.htm
GetUnassignedImages|Reference/Benchmarking/GetUnassignedImages.htm
GetUpdateTime|Reference/Benchmarking/GetUpdateTime.htm
ClearTweenCamera|Reference/Tweening/ClearTweenCamera.htm
CountWindowsDrives|Reference/File/CountWindowsDrives.htm
GetWindowsDrive|Reference/File/GetWindowsDrive.htm
IsAbsolutePath|Reference/File/IsAbsolutePath.htm
JoinPaths|Reference/File/JoinPaths.htm
SimplifyPath|Reference/File/SimplifyPath.htm
Create3DPhysicsWorld|Reference/3DPhysics/Create3DPhysicsWorld.htm
Create3DPhysicsWorld|Reference/3DPhysics/Create3DPhysicsWorld.htm
Debug3DPhysicsWorld|Reference/3DPhysics/Debug3DPhysicsWorld.htm
Delete3DPhysicsWorld|Reference/3DPhysics/Delete3DPhysicsWorld.htm
Get3DPhysicsActiveObjects|Reference/3DPhysics/Get3DPhysicsActiveObjects.htm
Get3DPhysicsTotalJoints|Reference/3DPhysics/Get3DPhysicsTotalJoints.htm
Get3DPhysicsTotalObjects|Reference/3DPhysics/Get3DPhysicsTotalObjects.htm
Reset3DPhysicsWorld|Reference/3DPhysics/Reset3DPhysicsWorld.htm
Set3DPhysicsGravity|Reference/3DPhysics/Set3DPhysicsGravity.htm
Set3DPhysicsGravity|Reference/3DPhysics/Set3DPhysicsGravity.htm
Step3DPhysicsWorld|Reference/3DPhysics/Step3DPhysicsWorld.htm
CloseNetwork|Reference/Multiplayer/CloseNetwork.htm
GetNetworkExists|Reference/Multiplayer/GetNetworkExists.htm
HostNetwork|Reference/Multiplayer/HostNetwork.htm
HostNetwork|Reference/Multiplayer/HostNetwork.htm
IsNetworkActive|Reference/Multiplayer/IsNetworkActive.htm
JoinNetwork|Reference/Multiplayer/JoinNetwork.htm
JoinNetwork|Reference/Multiplayer/JoinNetwork.htm
SetNetworkAllowClients|Reference/Multiplayer/SetNetworkAllowClients.htm
SetNetworkLatency|Reference/Multiplayer/SetNetworkLatency.htm
SetNetworkNoMoreClients|Reference/Multiplayer/SetNetworkNoMoreClients.htm
ARControlCamera|Reference/Extras/ARControlCamera.htm
ARCreateAnchorFromHitTest|Reference/Extras/ARCreateAnchorFromHitTest.htm
ARCreateAnchorFromPlane|Reference/Extras/ARCreateAnchorFromPlane.htm
ARDeleteAnchor|Reference/Extras/ARDeleteAnchor.htm
ARDestroy|Reference/Extras/ARDestroy.htm
ARDrawBackground|Reference/Extras/ARDrawBackground.htm
ARFixObjectToAnchor|Reference/Extras/ARFixObjectToAnchor.htm
ARGetAnchorStatus|Reference/Extras/ARGetAnchorStatus.htm
ARGetHitTestNormalX|Reference/Extras/ARGetHitTestNormalX.htm
ARGetHitTestNormalY|Reference/Extras/ARGetHitTestNormalY.htm
ARGetHitTestNormalZ|Reference/Extras/ARGetHitTestNormalZ.htm
ARGetHitTestType|Reference/Extras/ARGetHitTestType.htm
ARGetHitTestX|Reference/Extras/ARGetHitTestX.htm
ARGetHitTestY|Reference/Extras/ARGetHitTestY.htm
ARGetHitTestZ|Reference/Extras/ARGetHitTestZ.htm
ARGetLightEstimate|Reference/Extras/ARGetLightEstimate.htm
ARGetPlaneAngleX|Reference/Extras/ARGetPlaneAngleX.htm
ARGetPlaneAngleY|Reference/Extras/ARGetPlaneAngleY.htm
ARGetPlaneAngleZ|Reference/Extras/ARGetPlaneAngleZ.htm
ARGetPlaneSizeX|Reference/Extras/ARGetPlaneSizeX.htm
ARGetPlaneSizeZ|Reference/Extras/ARGetPlaneSizeZ.htm
ARGetPlaneX|Reference/Extras/ARGetPlaneX.htm
ARGetPlaneY|Reference/Extras/ARGetPlaneY.htm
ARGetPlaneZ|Reference/Extras/ARGetPlaneZ.htm
ARGetPlanes|Reference/Extras/ARGetPlanes.htm
ARGetPlanesFinish|Reference/Extras/ARGetPlanesFinish.htm
ARGetStatus|Reference/Extras/ARGetStatus.htm
ARHitTest|Reference/Extras/ARHitTest.htm
ARHitTestFinish|Reference/Extras/ARHitTestFinish.htm
ARSetLightEstimationMode|Reference/Extras/ARSetLightEstimationMode.htm
ARSetPlaneDetectionMode|Reference/Extras/ARSetPlaneDetectionMode.htm
ARSetup|Reference/Extras/ARSetup.htm
SetSnapChatStickerSettings|Reference/Extras/SetSnapChatStickerSettings.htm
ShareSnapChatImage|Reference/Extras/ShareSnapChatImage.htm
AddVirtualJoystick|Reference/Input/AddVirtualJoystick.htm
DeleteVirtualJoystick|Reference/Input/DeleteVirtualJoystick.htm
GetVirtualJoystickExists|Reference/Input/GetVirtualJoystickExists.htm
GetVirtualJoystickX|Reference/Input/GetVirtualJoystickX.htm
GetVirtualJoystickY|Reference/Input/GetVirtualJoystickY.htm
SetVirtualJoystickActive|Reference/Input/SetVirtualJoystickActive.htm
SetVirtualJoystickAlpha|Reference/Input/SetVirtualJoystickAlpha.htm
SetVirtualJoystickDeadZone|Reference/Input/SetVirtualJoystickDeadZone.htm
SetVirtualJoystickImageInner|Reference/Input/SetVirtualJoystickImageInner.htm
SetVirtualJoystickImageOuter|Reference/Input/SetVirtualJoystickImageOuter.htm
SetVirtualJoystickPosition|Reference/Input/SetVirtualJoystickPosition.htm
SetVirtualJoystickSize|Reference/Input/SetVirtualJoystickSize.htm
SetVirtualJoystickVisible|Reference/Input/SetVirtualJoystickVisible.htm
ACos|Reference/Core/ACos.htm
ACosRad|Reference/Core/ACosRad.htm
ASin|Reference/Core/ASin.htm
ASinRad|Reference/Core/ASinRad.htm
ATan|Reference/Core/ATan.htm
ATan2|Reference/Core/ATan2.htm
ATan2Rad|Reference/Core/ATan2Rad.htm
ATanFull|Reference/Core/ATanFull.htm
ATanFullRad|Reference/Core/ATanFullRad.htm
ATanRad|Reference/Core/ATanRad.htm
Abs|Reference/Core/Abs.htm
Ceil|Reference/Core/Ceil.htm
Cos|Reference/Core/Cos.htm
CosRad|Reference/Core/CosRad.htm
FMod|Reference/Core/FMod.htm
Floor|Reference/Core/Floor.htm
Log|Reference/Core/Log.htm
Mod|Reference/Core/Mod.htm
Pow|Reference/Core/Pow.htm
Random|Reference/Core/Random.htm
Random|Reference/Core/Random.htm
Random2|Reference/Core/Random2.htm
Random2|Reference/Core/Random2.htm
RandomSign|Reference/Core/RandomSign.htm
Round|Reference/Core/Round.htm
SetRandomSeed|Reference/Core/SetRandomSeed.htm
SetRandomSeed2|Reference/Core/SetRandomSeed2.htm
Sin|Reference/Core/Sin.htm
SinRad|Reference/Core/SinRad.htm
Sqrt|Reference/Core/Sqrt.htm
Tan|Reference/Core/Tan.htm
TanRad|Reference/Core/TanRad.htm
Trunc|Reference/Core/Trunc.htm
PlayYoutubeVideo|Reference/Video/PlayYoutubeVideo.htm
Add3DParticlesColorKeyFrame|Reference/3DParticles/Add3DParticlesColorKeyFrame.htm
Add3DParticlesForce|Reference/3DParticles/Add3DParticlesForce.htm
Add3DParticlesScaleKeyFrame|Reference/3DParticles/Add3DParticlesScaleKeyFrame.htm
Clear3DParticlesColors|Reference/3DParticles/Clear3DParticlesColors.htm
Clear3DParticlesForces|Reference/3DParticles/Clear3DParticlesForces.htm
Clear3DParticlesScales|Reference/3DParticles/Clear3DParticlesScales.htm
Draw3DParticles|Reference/3DParticles/Draw3DParticles.htm
Get3DParticlesActive|Reference/3DParticles/Get3DParticlesActive.htm
Get3DParticlesDirectionRange1|Reference/3DParticles/Get3DParticlesDirectionRange1.htm
Get3DParticlesDirectionRange2|Reference/3DParticles/Get3DParticlesDirectionRange2.htm
Get3DParticlesDirectionX|Reference/3DParticles/Get3DParticlesDirectionX.htm
Get3DParticlesDirectionY|Reference/3DParticles/Get3DParticlesDirectionY.htm
Get3DParticlesDirectionZ|Reference/3DParticles/Get3DParticlesDirectionZ.htm
Get3DParticlesExists|Reference/3DParticles/Get3DParticlesExists.htm
Get3DParticlesFrequency|Reference/3DParticles/Get3DParticlesFrequency.htm
Get3DParticlesLife|Reference/3DParticles/Get3DParticlesLife.htm
Get3DParticlesMaxReached|Reference/3DParticles/Get3DParticlesMaxReached.htm
Get3DParticlesSize|Reference/3DParticles/Get3DParticlesSize.htm
Get3DParticlesVisible|Reference/3DParticles/Get3DParticlesVisible.htm
Get3DParticlesX|Reference/3DParticles/Get3DParticlesX.htm
Get3DParticlesY|Reference/3DParticles/Get3DParticlesY.htm
Get3DParticlesZ|Reference/3DParticles/Get3DParticlesZ.htm
Offset3DParticles|Reference/3DParticles/Offset3DParticles.htm
Reset3DParticleCount|Reference/3DParticles/Reset3DParticleCount.htm
Set3DParticlesActive|Reference/3DParticles/Set3DParticlesActive.htm
Set3DParticlesColorInterpolation|Reference/3DParticles/Set3DParticlesColorInterpolation.htm
Set3DParticlesDirection|Reference/3DParticles/Set3DParticlesDirection.htm
Set3DParticlesDirectionRange|Reference/3DParticles/Set3DParticlesDirectionRange.htm
Set3DParticlesFrequency|Reference/3DParticles/Set3DParticlesFrequency.htm
Set3DParticlesImage|Reference/3DParticles/Set3DParticlesImage.htm
Set3DParticlesLife|Reference/3DParticles/Set3DParticlesLife.htm
Set3DParticlesMax|Reference/3DParticles/Set3DParticlesMax.htm
Set3DParticlesPosition|Reference/3DParticles/Set3DParticlesPosition.htm
Set3DParticlesSize|Reference/3DParticles/Set3DParticlesSize.htm
Set3DParticlesStartZone|Reference/3DParticles/Set3DParticlesStartZone.htm
Set3DParticlesTransparency|Reference/3DParticles/Set3DParticlesTransparency.htm
Set3DParticlesVelocityRange|Reference/3DParticles/Set3DParticlesVelocityRange.htm
Set3DParticlesVisible|Reference/3DParticles/Set3DParticlesVisible.htm
Update3DParticles|Reference/3DParticles/Update3DParticles.htm
DeleteShader|Reference/3D/DeleteShader.htm
GetShaderExists|Reference/3D/GetShaderExists.htm
GetSupportedShaderVaryings|Reference/3D/GetSupportedShaderVaryings.htm
LoadFullScreenShader|Reference/3D/LoadFullScreenShader.htm
LoadFullScreenShader|Reference/3D/LoadFullScreenShader.htm
LoadShader|Reference/3D/LoadShader.htm
LoadShader|Reference/3D/LoadShader.htm
LoadShaderFromString|Reference/3D/LoadShaderFromString.htm
LoadShaderFromString|Reference/3D/LoadShaderFromString.htm
LoadSpriteShader|Reference/3D/LoadSpriteShader.htm
LoadSpriteShader|Reference/3D/LoadSpriteShader.htm
SetShaderConstantArrayByName|Reference/3D/SetShaderConstantArrayByName.htm
SetShaderConstantByName|Reference/3D/SetShaderConstantByName.htm
DeleteSharedVariable|Reference/Extras/DeleteSharedVariable.htm
LoadSharedVariable|Reference/Extras/LoadSharedVariable.htm
SaveSharedVariable|Reference/Extras/SaveSharedVariable.htm
SetSharedVariableAppGroup|Reference/Extras/SetSharedVariableAppGroup.htm
AddSpriteShapeBox|Reference/Sprite/AddSpriteShapeBox.htm
AddSpriteShapeChain|Reference/Sprite/AddSpriteShapeChain.htm
AddSpriteShapeCircle|Reference/Sprite/AddSpriteShapeCircle.htm
AddSpriteShapePolygon|Reference/Sprite/AddSpriteShapePolygon.htm
CalculateSpritePhysicsCOM|Reference/Sprite/CalculateSpritePhysicsCOM.htm
ClearSpriteShapes|Reference/Sprite/ClearSpriteShapes.htm
GetPhysicsCollision|Reference/Sprite/GetPhysicsCollision.htm
GetPhysicsCollisionWorldX|Reference/Sprite/GetPhysicsCollisionWorldX.htm
GetPhysicsCollisionWorldY|Reference/Sprite/GetPhysicsCollisionWorldY.htm
GetPhysicsCollisionX|Reference/Sprite/GetPhysicsCollisionX.htm
GetPhysicsCollisionY|Reference/Sprite/GetPhysicsCollisionY.htm
GetSpriteNumShapes|Reference/Sprite/GetSpriteNumShapes.htm
GetSpritePhysicsAngularVelocity|Reference/Sprite/GetSpritePhysicsAngularVelocity.htm
GetSpritePhysicsCOMX|Reference/Sprite/GetSpritePhysicsCOMX.htm
GetSpritePhysicsCOMY|Reference/Sprite/GetSpritePhysicsCOMY.htm
GetSpritePhysicsGravityScale|Reference/Sprite/GetSpritePhysicsGravityScale.htm
GetSpritePhysicsInertia|Reference/Sprite/GetSpritePhysicsInertia.htm
GetSpritePhysicsIsAwake|Reference/Sprite/GetSpritePhysicsIsAwake.htm
GetSpritePhysicsIsBullet|Reference/Sprite/GetSpritePhysicsIsBullet.htm
GetSpritePhysicsMass|Reference/Sprite/GetSpritePhysicsMass.htm
GetSpritePhysicsVelocityX|Reference/Sprite/GetSpritePhysicsVelocityX.htm
GetSpritePhysicsVelocityY|Reference/Sprite/GetSpritePhysicsVelocityY.htm
GetSpriteShapeNumVertices|Reference/Sprite/GetSpriteShapeNumVertices.htm
GetSpriteShapeVertexX|Reference/Sprite/GetSpriteShapeVertexX.htm
GetSpriteShapeVertexY|Reference/Sprite/GetSpriteShapeVertexY.htm
SetSpriteCategoryBit|Reference/Sprite/SetSpriteCategoryBit.htm
SetSpriteCategoryBit|Reference/Sprite/SetSpriteCategoryBit.htm
SetSpriteCategoryBits|Reference/Sprite/SetSpriteCategoryBits.htm
SetSpriteCategoryBits|Reference/Sprite/SetSpriteCategoryBits.htm
SetSpriteCollideBit|Reference/Sprite/SetSpriteCollideBit.htm
SetSpriteCollideBit|Reference/Sprite/SetSpriteCollideBit.htm
SetSpriteCollideBits|Reference/Sprite/SetSpriteCollideBits.htm
SetSpriteCollideBits|Reference/Sprite/SetSpriteCollideBits.htm
SetSpriteGroup|Reference/Sprite/SetSpriteGroup.htm
SetSpriteGroup|Reference/Sprite/SetSpriteGroup.htm
SetSpritePhysicsAllowSleep|Reference/Sprite/SetSpritePhysicsAllowSleep.htm
SetSpritePhysicsAngularDamping|Reference/Sprite/SetSpritePhysicsAngularDamping.htm
SetSpritePhysicsAngularImpulse|Reference/Sprite/SetSpritePhysicsAngularImpulse.htm
SetSpritePhysicsAngularVelocity|Reference/Sprite/SetSpritePhysicsAngularVelocity.htm
SetSpritePhysicsCOM|Reference/Sprite/SetSpritePhysicsCOM.htm
SetSpritePhysicsCanRotate|Reference/Sprite/SetSpritePhysicsCanRotate.htm
SetSpritePhysicsDamping|Reference/Sprite/SetSpritePhysicsDamping.htm
SetSpritePhysicsDelete|Reference/Sprite/SetSpritePhysicsDelete.htm
SetSpritePhysicsDensity|Reference/Sprite/SetSpritePhysicsDensity.htm
SetSpritePhysicsForce|Reference/Sprite/SetSpritePhysicsForce.htm
SetSpritePhysicsFriction|Reference/Sprite/SetSpritePhysicsFriction.htm
SetSpritePhysicsFriction|Reference/Sprite/SetSpritePhysicsFriction.htm
SetSpritePhysicsGravityScale|Reference/Sprite/SetSpritePhysicsGravityScale.htm
SetSpritePhysicsImpulse|Reference/Sprite/SetSpritePhysicsImpulse.htm
SetSpritePhysicsInitiallyAwake|Reference/Sprite/SetSpritePhysicsInitiallyAwake.htm
SetSpritePhysicsIsBullet|Reference/Sprite/SetSpritePhysicsIsBullet.htm
SetSpritePhysicsIsSensor|Reference/Sprite/SetSpritePhysicsIsSensor.htm
SetSpritePhysicsIsSensor|Reference/Sprite/SetSpritePhysicsIsSensor.htm
SetSpritePhysicsMass|Reference/Sprite/SetSpritePhysicsMass.htm
SetSpritePhysicsOff|Reference/Sprite/SetSpritePhysicsOff.htm
SetSpritePhysicsOn|Reference/Sprite/SetSpritePhysicsOn.htm
SetSpritePhysicsRestitution|Reference/Sprite/SetSpritePhysicsRestitution.htm
SetSpritePhysicsRestitution|Reference/Sprite/SetSpritePhysicsRestitution.htm
SetSpritePhysicsTorque|Reference/Sprite/SetSpritePhysicsTorque.htm
SetSpritePhysicsVelocity|Reference/Sprite/SetSpritePhysicsVelocity.htm
SetSpriteShape|Reference/Sprite/SetSpriteShape.htm
SetSpriteShape|Reference/Sprite/SetSpriteShape.htm
SetSpriteShapeBox|Reference/Sprite/SetSpriteShapeBox.htm
SetSpriteShapeBox|Reference/Sprite/SetSpriteShapeBox.htm
SetSpriteShapeChain|Reference/Sprite/SetSpriteShapeChain.htm
SetSpriteShapeCircle|Reference/Sprite/SetSpriteShapeCircle.htm
SetSpriteShapeCircle|Reference/Sprite/SetSpriteShapeCircle.htm
SetSpriteShapePolygon|Reference/Sprite/SetSpriteShapePolygon.htm
SetSpriteShapePolygon|Reference/Sprite/SetSpriteShapePolygon.htm
AddTweenChainCamera|Reference/Tweening/AddTweenChainCamera.htm
AddTweenChainChar|Reference/Tweening/AddTweenChainChar.htm
AddTweenChainCustom|Reference/Tweening/AddTweenChainCustom.htm
AddTweenChainObject|Reference/Tweening/AddTweenChainObject.htm
AddTweenChainSprite|Reference/Tweening/AddTweenChainSprite.htm
AddTweenChainText|Reference/Tweening/AddTweenChainText.htm
ClearTweenChain|Reference/Tweening/ClearTweenChain.htm
CreateTweenChain|Reference/Tweening/CreateTweenChain.htm
CreateTweenChain|Reference/Tweening/CreateTweenChain.htm
DeleteTweenChain|Reference/Tweening/DeleteTweenChain.htm
GetTweenChainEndTime|Reference/Tweening/GetTweenChainEndTime.htm
GetTweenChainPlaying|Reference/Tweening/GetTweenChainPlaying.htm
PauseTweenChain|Reference/Tweening/PauseTweenChain.htm
PlayTweenChain|Reference/Tweening/PlayTweenChain.htm
SetTweenChainTime|Reference/Tweening/SetTweenChainTime.htm
StopTweenChain|Reference/Tweening/StopTweenChain.htm
GetDirectionAngle|Reference/Input/GetDirectionAngle.htm
GetDirectionSpeed|Reference/Input/GetDirectionSpeed.htm
GetDirectionX|Reference/Input/GetDirectionX.htm
GetDirectionY|Reference/Input/GetDirectionY.htm
SetGlobal3DDepth|Reference/3D/SetGlobal3DDepth.htm
GetChosenImage|Reference/Image/GetChosenImage.htm
IsChoosingImage|Reference/Image/IsChoosingImage.htm
ShowChooseImageScreen|Reference/Image/ShowChooseImageScreen.htm
GetImageFilename|Reference/Image/GetImageFilename.htm
GetImageHeight|Reference/Image/GetImageHeight.htm
GetImageWidth|Reference/Image/GetImageWidth.htm
SetImageMagFilter|Reference/Image/SetImageMagFilter.htm
SetImageMinFilter|Reference/Image/SetImageMinFilter.htm
SetImageWrapU|Reference/Image/SetImageWrapU.htm
SetImageWrapV|Reference/Image/SetImageWrapV.htm
SetObjectShapeBox|Reference/3DPhysics/SetObjectShapeBox.htm
SetObjectShapeBox|Reference/3DPhysics/SetObjectShapeBox.htm
SetObjectShapeBox|Reference/3DPhysics/SetObjectShapeBox.htm
SetObjectShapeCapsule|Reference/3DPhysics/SetObjectShapeCapsule.htm
SetObjectShapeCapsule|Reference/3DPhysics/SetObjectShapeCapsule.htm
SetObjectShapeCapsule|Reference/3DPhysics/SetObjectShapeCapsule.htm
SetObjectShapeCompound|Reference/3DPhysics/SetObjectShapeCompound.htm
SetObjectShapeCone|Reference/3DPhysics/SetObjectShapeCone.htm
SetObjectShapeCone|Reference/3DPhysics/SetObjectShapeCone.htm
SetObjectShapeConvexHull|Reference/3DPhysics/SetObjectShapeConvexHull.htm
SetObjectShapeCylinder|Reference/3DPhysics/SetObjectShapeCylinder.htm
SetObjectShapeCylinder|Reference/3DPhysics/SetObjectShapeCylinder.htm
SetObjectShapeSphere|Reference/3DPhysics/SetObjectShapeSphere.htm
SetObjectShapeSphere|Reference/3DPhysics/SetObjectShapeSphere.htm
SetObjectShapeStaticPolygon|Reference/3DPhysics/SetObjectShapeStaticPolygon.htm
CreateTweenObject|Reference/Tweening/CreateTweenObject.htm
CreateTweenObject|Reference/Tweening/CreateTweenObject.htm
GetTweenObjectEndTime|Reference/Tweening/GetTweenObjectEndTime.htm
GetTweenObjectExists|Reference/Tweening/GetTweenObjectExists.htm
GetTweenObjectPlaying|Reference/Tweening/GetTweenObjectPlaying.htm
GetTweenObjectTime|Reference/Tweening/GetTweenObjectTime.htm
PauseTweenObject|Reference/Tweening/PauseTweenObject.htm
PlayTweenObject|Reference/Tweening/PlayTweenObject.htm
ResumeTweenObject|Reference/Tweening/ResumeTweenObject.htm
SetTweenObjectAlpha|Reference/Tweening/SetTweenObjectAlpha.htm
SetTweenObjectAngleX|Reference/Tweening/SetTweenObjectAngleX.htm
SetTweenObjectAngleY|Reference/Tweening/SetTweenObjectAngleY.htm
SetTweenObjectAngleZ|Reference/Tweening/SetTweenObjectAngleZ.htm
SetTweenObjectBlue|Reference/Tweening/SetTweenObjectBlue.htm
SetTweenObjectGreen|Reference/Tweening/SetTweenObjectGreen.htm
SetTweenObjectRed|Reference/Tweening/SetTweenObjectRed.htm
SetTweenObjectScaleX|Reference/Tweening/SetTweenObjectScaleX.htm
SetTweenObjectScaleY|Reference/Tweening/SetTweenObjectScaleY.htm
SetTweenObjectScaleZ|Reference/Tweening/SetTweenObjectScaleZ.htm
SetTweenObjectX|Reference/Tweening/SetTweenObjectX.htm
SetTweenObjectY|Reference/Tweening/SetTweenObjectY.htm
SetTweenObjectZ|Reference/Tweening/SetTweenObjectZ.htm
StopTweenObject|Reference/Tweening/StopTweenObject.htm
ClearPointLights|Reference/3D/ClearPointLights.htm
CreatePointLight|Reference/3D/CreatePointLight.htm
DeletePointLight|Reference/3D/DeletePointLight.htm
GetPointLightExists|Reference/3D/GetPointLightExists.htm
SetAmbientColor|Reference/3D/SetAmbientColor.htm
SetPointLightColor|Reference/3D/SetPointLightColor.htm
SetPointLightMode|Reference/3D/SetPointLightMode.htm
SetPointLightPosition|Reference/3D/SetPointLightPosition.htm
SetPointLightRadius|Reference/3D/SetPointLightRadius.htm
SetSunActive|Reference/3D/SetSunActive.htm
SetSunColor|Reference/3D/SetSunColor.htm
SetSunDirection|Reference/3D/SetSunDirection.htm
CancelLocalNotification|Reference/Extras/CancelLocalNotification.htm
GetLocalNotificationExists|Reference/Extras/GetLocalNotificationExists.htm
GetLocalNotificationMessage|Reference/Extras/GetLocalNotificationMessage.htm
GetLocalNotificationTime|Reference/Extras/GetLocalNotificationTime.htm
SetLocalNotification|Reference/Extras/SetLocalNotification.htm
SetLocalNotification|Reference/Extras/SetLocalNotification.htm
GetLastChar|Reference/Input/GetLastChar.htm
GetTextInput|Reference/Input/GetTextInput.htm
GetTextInputCancelled|Reference/Input/GetTextInputCancelled.htm
GetTextInputCompleted|Reference/Input/GetTextInputCompleted.htm
GetTextInputState|Reference/Input/GetTextInputState.htm
SetCursorBlinkTime|Reference/Input/SetCursorBlinkTime.htm
SetTextInputMaxChars|Reference/Input/SetTextInputMaxChars.htm
StartTextInput|Reference/Input/StartTextInput.htm
StartTextInput|Reference/Input/StartTextInput.htm
StopTextInput|Reference/Input/StopTextInput.htm
ClearTweenChar|Reference/Tweening/ClearTweenChar.htm
CreateTweenChar|Reference/Tweening/CreateTweenChar.htm
CreateTweenChar|Reference/Tweening/CreateTweenChar.htm
GetTweenCharEndTime|Reference/Tweening/GetTweenCharEndTime.htm
GetTweenCharExists|Reference/Tweening/GetTweenCharExists.htm
GetTweenCharPlaying|Reference/Tweening/GetTweenCharPlaying.htm
GetTweenCharTime|Reference/Tweening/GetTweenCharTime.htm
PauseTweenChar|Reference/Tweening/PauseTweenChar.htm
PlayTweenChar|Reference/Tweening/PlayTweenChar.htm
ResumeTweenChar|Reference/Tweening/ResumeTweenChar.htm
SetTweenCharAlpha|Reference/Tweening/SetTweenCharAlpha.htm
SetTweenCharAngle|Reference/Tweening/SetTweenCharAngle.htm
SetTweenCharBlue|Reference/Tweening/SetTweenCharBlue.htm
SetTweenCharGreen|Reference/Tweening/SetTweenCharGreen.htm
SetTweenCharRed|Reference/Tweening/SetTweenCharRed.htm
SetTweenCharX|Reference/Tweening/SetTweenCharX.htm
SetTweenCharY|Reference/Tweening/SetTweenCharY.htm
StopTweenChar|Reference/Tweening/StopTweenChar.htm
DeleteTween|Reference/Tweening/DeleteTween.htm
GetTweenExists|Reference/Tweening/GetTweenExists.htm
SetTweenDuration|Reference/Tweening/SetTweenDuration.htm
UpdateAllTweens|Reference/Tweening/UpdateAllTweens.htm
UpdateTweenCamera|Reference/Tweening/UpdateTweenCamera.htm
UpdateTweenChain|Reference/Tweening/UpdateTweenChain.htm
UpdateTweenChar|Reference/Tweening/UpdateTweenChar.htm
UpdateTweenCustom|Reference/Tweening/UpdateTweenCustom.htm
UpdateTweenObject|Reference/Tweening/UpdateTweenObject.htm
UpdateTweenSprite|Reference/Tweening/UpdateTweenSprite.htm
UpdateTweenText|Reference/Tweening/UpdateTweenText.htm
CreateParticles|Reference/Particles/CreateParticles.htm
CreateParticles|Reference/Particles/CreateParticles.htm
DeleteParticles|Reference/Particles/DeleteParticles.htm
GetButtonPressed|Reference/Input/GetButtonPressed.htm
GetButtonReleased|Reference/Input/GetButtonReleased.htm
GetButtonState|Reference/Input/GetButtonState.htm
SetButtonScreenPosition|Reference/Input/SetButtonScreenPosition.htm
LoadObjectShape|Reference/3DPhysics/LoadObjectShape.htm
SaveObjectShape|Reference/3DPhysics/SaveObjectShape.htm
CreateVector3|Reference/Maths/CreateVector3.htm
CreateVector3|Reference/Maths/CreateVector3.htm
DeleteVector3|Reference/Maths/DeleteVector3.htm
GetVector3Add|Reference/Maths/GetVector3Add.htm
GetVector3Cross|Reference/Maths/GetVector3Cross.htm
GetVector3Distance|Reference/Maths/GetVector3Distance.htm
GetVector3Dot|Reference/Maths/GetVector3Dot.htm
GetVector3Length|Reference/Maths/GetVector3Length.htm
GetVector3Multiply|Reference/Maths/GetVector3Multiply.htm
GetVector3X|Reference/Maths/GetVector3X.htm
GetVector3Y|Reference/Maths/GetVector3Y.htm
GetVector3Z|Reference/Maths/GetVector3Z.htm
SetVector3|Reference/Maths/SetVector3.htm
GetCurrentDate|Reference/Time/GetCurrentDate.htm
GetCurrentTime|Reference/Time/GetCurrentTime.htm
GetDayOfWeek|Reference/Time/GetDayOfWeek.htm
GetDaysFromUnix|Reference/Time/GetDaysFromUnix.htm
GetHoursFromUnix|Reference/Time/GetHoursFromUnix.htm
GetLeapYear|Reference/Time/GetLeapYear.htm
GetMinutesFromUnix|Reference/Time/GetMinutesFromUnix.htm
GetMonthFromUnix|Reference/Time/GetMonthFromUnix.htm
GetSecondsFromUnix|Reference/Time/GetSecondsFromUnix.htm
GetUnixFromDate|Reference/Time/GetUnixFromDate.htm
GetUnixTime|Reference/Time/GetUnixTime.htm
GetYearFromUnix|Reference/Time/GetYearFromUnix.htm
FirebaseLogEvent|Reference/Extras/FirebaseLogEvent.htm
FirebaseSetup|Reference/Extras/FirebaseSetup.htm
CacheRewardAdChartboost|Reference/Advert/CacheRewardAdChartboost.htm
GetConsentStatusAdMob|Reference/Advert/GetConsentStatusAdMob.htm
GetFullscreenAdvertLoadedAdMob|Reference/Advert/GetFullscreenAdvertLoadedAdMob.htm
GetFullscreenAdvertLoadedAmazon|Reference/Advert/GetFullscreenAdvertLoadedAmazon.htm
GetFullscreenAdvertLoadedChartboost|Reference/Advert/GetFullscreenAdvertLoadedChartboost.htm
GetRewardAdLoadedAdMob|Reference/Advert/GetRewardAdLoadedAdMob.htm
GetRewardAdLoadedChartboost|Reference/Advert/GetRewardAdLoadedChartboost.htm
GetRewardAdRewardedAdMob|Reference/Advert/GetRewardAdRewardedAdMob.htm
GetRewardAdRewardedChartboost|Reference/Advert/GetRewardAdRewardedChartboost.htm
GetRewardAdValueAdMob|Reference/Advert/GetRewardAdValueAdMob.htm
LoadConsentStatusAdMob|Reference/Advert/LoadConsentStatusAdMob.htm
OverrideConsentAdMob|Reference/Advert/OverrideConsentAdMob.htm
RequestConsentAdMob|Reference/Advert/RequestConsentAdMob.htm
ResetRewardAdMob|Reference/Advert/ResetRewardAdMob.htm
ResetRewardChartboost|Reference/Advert/ResetRewardChartboost.htm
SetAdMobChildRating|Reference/Advert/SetAdMobChildRating.htm
SetAdMobDetails|Reference/Advert/SetAdMobDetails.htm
SetAdMobRewardAdDetails|Reference/Advert/SetAdMobRewardAdDetails.htm
SetAdMobTesting|Reference/Advert/SetAdMobTesting.htm
SetAmazonAdDetails|Reference/Advert/SetAmazonAdDetails.htm
SetAmazonAdTesting|Reference/Advert/SetAmazonAdTesting.htm
ShowFullscreenAdvertAdMob|Reference/Advert/ShowFullscreenAdvertAdMob.htm
ShowRewardAdAdMob|Reference/Advert/ShowRewardAdAdMob.htm
ShowRewardAdChartboost|Reference/Advert/ShowRewardAdChartboost.htm
FacebookActivateAppTracking|Reference/Extras/FacebookActivateAppTracking.htm
FacebookDestroyLikeButton|Reference/Extras/FacebookDestroyLikeButton.htm
FacebookDownloadFriendsPhoto|Reference/Extras/FacebookDownloadFriendsPhoto.htm
FacebookGetAccessToken|Reference/Extras/FacebookGetAccessToken.htm
FacebookGetFriends|Reference/Extras/FacebookGetFriends.htm
FacebookGetFriendsCount|Reference/Extras/FacebookGetFriendsCount.htm
FacebookGetFriendsID|Reference/Extras/FacebookGetFriendsID.htm
FacebookGetFriendsName|Reference/Extras/FacebookGetFriendsName.htm
FacebookGetFriendsState|Reference/Extras/FacebookGetFriendsState.htm
FacebookGetUserID|Reference/Extras/FacebookGetUserID.htm
FacebookGetUserName|Reference/Extras/FacebookGetUserName.htm
FacebookInviteFriend|Reference/Extras/FacebookInviteFriend.htm
FacebookLogin|Reference/Extras/FacebookLogin.htm
FacebookLogout|Reference/Extras/FacebookLogout.htm
FacebookPostOnFriendsWall|Reference/Extras/FacebookPostOnFriendsWall.htm
FacebookPostOnMyWall|Reference/Extras/FacebookPostOnMyWall.htm
FacebookSetup|Reference/Extras/FacebookSetup.htm
FacebookShowLikeButton|Reference/Extras/FacebookShowLikeButton.htm
GetFacebookDownloadFile|Reference/Extras/GetFacebookDownloadFile.htm
GetFacebookDownloadState|Reference/Extras/GetFacebookDownloadState.htm
GetFacebookLoggedIn|Reference/Extras/GetFacebookLoggedIn.htm
CreateEditBox|Reference/Input/CreateEditBox.htm
CreateEditBox|Reference/Input/CreateEditBox.htm
DeleteEditBox|Reference/Input/DeleteEditBox.htm
FixEditBoxToScreen|Reference/Input/FixEditBoxToScreen.htm
GetCurrentEditBox|Reference/Input/GetCurrentEditBox.htm
GetEditBoxActive|Reference/Input/GetEditBoxActive.htm
GetEditBoxChanged|Reference/Input/GetEditBoxChanged.htm
GetEditBoxCursorPosition|Reference/Input/GetEditBoxCursorPosition.htm
GetEditBoxDepth|Reference/Input/GetEditBoxDepth.htm
GetEditBoxExists|Reference/Input/GetEditBoxExists.htm
GetEditBoxHasFocus|Reference/Input/GetEditBoxHasFocus.htm
GetEditBoxHeight|Reference/Input/GetEditBoxHeight.htm
GetEditBoxLines|Reference/Input/GetEditBoxLines.htm
GetEditBoxText|Reference/Input/GetEditBoxText.htm
GetEditBoxVisible|Reference/Input/GetEditBoxVisible.htm
GetEditBoxWidth|Reference/Input/GetEditBoxWidth.htm
GetEditBoxX|Reference/Input/GetEditBoxX.htm
GetEditBoxY|Reference/Input/GetEditBoxY.htm
SetEditBoxActive|Reference/Input/SetEditBoxActive.htm
SetEditBoxBackgroundColor|Reference/Input/SetEditBoxBackgroundColor.htm
SetEditBoxBackgroundImage|Reference/Input/SetEditBoxBackgroundImage.htm
SetEditBoxBorderColor|Reference/Input/SetEditBoxBorderColor.htm
SetEditBoxBorderImage|Reference/Input/SetEditBoxBorderImage.htm
SetEditBoxBorderSize|Reference/Input/SetEditBoxBorderSize.htm
SetEditBoxCursorBlinkTime|Reference/Input/SetEditBoxCursorBlinkTime.htm
SetEditBoxCursorColor|Reference/Input/SetEditBoxCursorColor.htm
SetEditBoxCursorPosition|Reference/Input/SetEditBoxCursorPosition.htm
SetEditBoxCursorWidth|Reference/Input/SetEditBoxCursorWidth.htm
SetEditBoxDepth|Reference/Input/SetEditBoxDepth.htm
SetEditBoxExtendedFontImage|Reference/Input/SetEditBoxExtendedFontImage.htm
SetEditBoxFocus|Reference/Input/SetEditBoxFocus.htm
SetEditBoxFont|Reference/Input/SetEditBoxFont.htm
SetEditBoxFontImage|Reference/Input/SetEditBoxFontImage.htm
SetEditBoxInputType|Reference/Input/SetEditBoxInputType.htm
SetEditBoxMaxChars|Reference/Input/SetEditBoxMaxChars.htm
SetEditBoxMaxLines|Reference/Input/SetEditBoxMaxLines.htm
SetEditBoxMultiLine|Reference/Input/SetEditBoxMultiLine.htm
SetEditBoxPasswordMode|Reference/Input/SetEditBoxPasswordMode.htm
SetEditBoxPosition|Reference/Input/SetEditBoxPosition.htm
SetEditBoxScissor|Reference/Input/SetEditBoxScissor.htm
SetEditBoxSize|Reference/Input/SetEditBoxSize.htm
SetEditBoxText|Reference/Input/SetEditBoxText.htm
SetEditBoxTextColor|Reference/Input/SetEditBoxTextColor.htm
SetEditBoxTextSize|Reference/Input/SetEditBoxTextSize.htm
SetEditBoxUseAlternateInput|Reference/Input/SetEditBoxUseAlternateInput.htm
SetEditBoxVisible|Reference/Input/SetEditBoxVisible.htm
SetEditBoxWrapMode|Reference/Input/SetEditBoxWrapMode.htm
AddParticlesColorKeyFrame|Reference/Particles/AddParticlesColorKeyFrame.htm
AddParticlesForce|Reference/Particles/AddParticlesForce.htm
AddParticlesScaleKeyFrame|Reference/Particles/AddParticlesScaleKeyFrame.htm
ClearParticlesColors|Reference/Particles/ClearParticlesColors.htm
ClearParticlesForces|Reference/Particles/ClearParticlesForces.htm
ClearParticlesScales|Reference/Particles/ClearParticlesScales.htm
DrawParticles|Reference/Particles/DrawParticles.htm
FixParticlesToScreen|Reference/Particles/FixParticlesToScreen.htm
GetParticlesActive|Reference/Particles/GetParticlesActive.htm
GetParticlesAngle|Reference/Particles/GetParticlesAngle.htm
GetParticlesAngleRad|Reference/Particles/GetParticlesAngleRad.htm
GetParticlesDepth|Reference/Particles/GetParticlesDepth.htm
GetParticlesDirectionX|Reference/Particles/GetParticlesDirectionX.htm
GetParticlesDirectionY|Reference/Particles/GetParticlesDirectionY.htm
GetParticlesExists|Reference/Particles/GetParticlesExists.htm
GetParticlesFrequency|Reference/Particles/GetParticlesFrequency.htm
GetParticlesLife|Reference/Particles/GetParticlesLife.htm
GetParticlesMaxReached|Reference/Particles/GetParticlesMaxReached.htm
GetParticlesSize|Reference/Particles/GetParticlesSize.htm
GetParticlesVisible|Reference/Particles/GetParticlesVisible.htm
GetParticlesX|Reference/Particles/GetParticlesX.htm
GetParticlesY|Reference/Particles/GetParticlesY.htm
OffsetParticles|Reference/Particles/OffsetParticles.htm
ResetParticleCount|Reference/Particles/ResetParticleCount.htm
SetParticlesActive|Reference/Particles/SetParticlesActive.htm
SetParticlesAngle|Reference/Particles/SetParticlesAngle.htm
SetParticlesAngleRad|Reference/Particles/SetParticlesAngleRad.htm
SetParticlesColorInterpolation|Reference/Particles/SetParticlesColorInterpolation.htm
SetParticlesDepth|Reference/Particles/SetParticlesDepth.htm
SetParticlesDirection|Reference/Particles/SetParticlesDirection.htm
SetParticlesFaceDirection|Reference/Particles/SetParticlesFaceDirection.htm
SetParticlesFrequency|Reference/Particles/SetParticlesFrequency.htm
SetParticlesImage|Reference/Particles/SetParticlesImage.htm
SetParticlesLife|Reference/Particles/SetParticlesLife.htm
SetParticlesMax|Reference/Particles/SetParticlesMax.htm
SetParticlesPosition|Reference/Particles/SetParticlesPosition.htm
SetParticlesRotationRange|Reference/Particles/SetParticlesRotationRange.htm
SetParticlesRotationRangeRad|Reference/Particles/SetParticlesRotationRangeRad.htm
SetParticlesSize|Reference/Particles/SetParticlesSize.htm
SetParticlesStartZone|Reference/Particles/SetParticlesStartZone.htm
SetParticlesTransparency|Reference/Particles/SetParticlesTransparency.htm
SetParticlesVelocityRange|Reference/Particles/SetParticlesVelocityRange.htm
SetParticlesVisible|Reference/Particles/SetParticlesVisible.htm
UpdateParticles|Reference/Particles/UpdateParticles.htm
CloneObject|Reference/3D/CloneObject.htm
CloneObject|Reference/3D/CloneObject.htm
CreateObjectBox|Reference/3D/CreateObjectBox.htm
CreateObjectBox|Reference/3D/CreateObjectBox.htm
CreateObjectCapsule|Reference/3D/CreateObjectCapsule.htm
CreateObjectCapsule|Reference/3D/CreateObjectCapsule.htm
CreateObjectCone|Reference/3D/CreateObjectCone.htm
CreateObjectCone|Reference/3D/CreateObjectCone.htm
CreateObjectCylinder|Reference/3D/CreateObjectCylinder.htm
CreateObjectCylinder|Reference/3D/CreateObjectCylinder.htm
CreateObjectFromHeightMap|Reference/3D/CreateObjectFromHeightMap.htm
CreateObjectFromHeightMap|Reference/3D/CreateObjectFromHeightMap.htm
CreateObjectFromObjectMesh|Reference/3D/CreateObjectFromObjectMesh.htm
CreateObjectFromObjectMesh|Reference/3D/CreateObjectFromObjectMesh.htm
CreateObjectFromRawHeightMap|Reference/3D/CreateObjectFromRawHeightMap.htm
CreateObjectFromRawHeightMap|Reference/3D/CreateObjectFromRawHeightMap.htm
CreateObjectPlane|Reference/3D/CreateObjectPlane.htm
CreateObjectPlane|Reference/3D/CreateObjectPlane.htm
CreateObjectQuad|Reference/3D/CreateObjectQuad.htm
CreateObjectQuad|Reference/3D/CreateObjectQuad.htm
CreateObjectSphere|Reference/3D/CreateObjectSphere.htm
CreateObjectSphere|Reference/3D/CreateObjectSphere.htm
DeleteAllObjects|Reference/3D/DeleteAllObjects.htm
DeleteObject|Reference/3D/DeleteObject.htm
DeleteObjectTree|Reference/3D/DeleteObjectTree.htm
DeleteObjectWithChildren|Reference/3D/DeleteObjectWithChildren.htm
DrawObject|Reference/3D/DrawObject.htm
FixObjectPivot|Reference/3D/FixObjectPivot.htm
FixObjectToBone|Reference/3D/FixObjectToBone.htm
FixObjectToCamera|Reference/3D/FixObjectToCamera.htm
FixObjectToObject|Reference/3D/FixObjectToObject.htm
Get3DVectorXFromScreen|Reference/3D/Get3DVectorXFromScreen.htm
Get3DVectorYFromScreen|Reference/3D/Get3DVectorYFromScreen.htm
Get3DVectorZFromScreen|Reference/3D/Get3DVectorZFromScreen.htm
GetObjectAlpha|Reference/3D/GetObjectAlpha.htm
GetObjectAngleX|Reference/3D/GetObjectAngleX.htm
GetObjectAngleY|Reference/3D/GetObjectAngleY.htm
GetObjectAngleZ|Reference/3D/GetObjectAngleZ.htm
GetObjectAnimationDuration|Reference/3D/GetObjectAnimationDuration.htm
GetObjectAnimationName|Reference/3D/GetObjectAnimationName.htm
GetObjectAnimationTime|Reference/3D/GetObjectAnimationTime.htm
GetObjectChildID|Reference/3D/GetObjectChildID.htm
GetObjectColorBlue|Reference/3D/GetObjectColorBlue.htm
GetObjectColorGreen|Reference/3D/GetObjectColorGreen.htm
GetObjectColorRed|Reference/3D/GetObjectColorRed.htm
GetObjectCullMode|Reference/3D/GetObjectCullMode.htm
GetObjectDepthBias|Reference/3D/GetObjectDepthBias.htm
GetObjectDepthReadMode|Reference/3D/GetObjectDepthReadMode.htm
GetObjectDepthWrite|Reference/3D/GetObjectDepthWrite.htm
GetObjectExists|Reference/3D/GetObjectExists.htm
GetObjectHeightMapHeight|Reference/3D/GetObjectHeightMapHeight.htm
GetObjectInScreen|Reference/3D/GetObjectInScreen.htm
GetObjectIsAnimating|Reference/3D/GetObjectIsAnimating.htm
GetObjectIsTweening|Reference/3D/GetObjectIsTweening.htm
GetObjectMeshSizeMaxX|Reference/3D/GetObjectMeshSizeMaxX.htm
GetObjectMeshSizeMaxY|Reference/3D/GetObjectMeshSizeMaxY.htm
GetObjectMeshSizeMaxZ|Reference/3D/GetObjectMeshSizeMaxZ.htm
GetObjectMeshSizeMinX|Reference/3D/GetObjectMeshSizeMinX.htm
GetObjectMeshSizeMinY|Reference/3D/GetObjectMeshSizeMinY.htm
GetObjectMeshSizeMinZ|Reference/3D/GetObjectMeshSizeMinZ.htm
GetObjectName|Reference/3D/GetObjectName.htm
GetObjectNumAnimations|Reference/3D/GetObjectNumAnimations.htm
GetObjectNumChildren|Reference/3D/GetObjectNumChildren.htm
GetObjectQuatW|Reference/3D/GetObjectQuatW.htm
GetObjectQuatX|Reference/3D/GetObjectQuatX.htm
GetObjectQuatY|Reference/3D/GetObjectQuatY.htm
GetObjectQuatZ|Reference/3D/GetObjectQuatZ.htm
GetObjectRayCastBounceX|Reference/3D/GetObjectRayCastBounceX.htm
GetObjectRayCastBounceY|Reference/3D/GetObjectRayCastBounceY.htm
GetObjectRayCastBounceZ|Reference/3D/GetObjectRayCastBounceZ.htm
GetObjectRayCastDistance|Reference/3D/GetObjectRayCastDistance.htm
GetObjectRayCastHitID|Reference/3D/GetObjectRayCastHitID.htm
GetObjectRayCastNormalX|Reference/3D/GetObjectRayCastNormalX.htm
GetObjectRayCastNormalY|Reference/3D/GetObjectRayCastNormalY.htm
GetObjectRayCastNormalZ|Reference/3D/GetObjectRayCastNormalZ.htm
GetObjectRayCastNumHits|Reference/3D/GetObjectRayCastNumHits.htm
GetObjectRayCastSlideX|Reference/3D/GetObjectRayCastSlideX.htm
GetObjectRayCastSlideY|Reference/3D/GetObjectRayCastSlideY.htm
GetObjectRayCastSlideZ|Reference/3D/GetObjectRayCastSlideZ.htm
GetObjectRayCastX|Reference/3D/GetObjectRayCastX.htm
GetObjectRayCastY|Reference/3D/GetObjectRayCastY.htm
GetObjectRayCastZ|Reference/3D/GetObjectRayCastZ.htm
GetObjectSizeMaxX|Reference/3D/GetObjectSizeMaxX.htm
GetObjectSizeMaxY|Reference/3D/GetObjectSizeMaxY.htm
GetObjectSizeMaxZ|Reference/3D/GetObjectSizeMaxZ.htm
GetObjectSizeMinX|Reference/3D/GetObjectSizeMinX.htm
GetObjectSizeMinY|Reference/3D/GetObjectSizeMinY.htm
GetObjectSizeMinZ|Reference/3D/GetObjectSizeMinZ.htm
GetObjectTransparency|Reference/3D/GetObjectTransparency.htm
GetObjectVisible|Reference/3D/GetObjectVisible.htm
GetObjectWorldAngleX|Reference/3D/GetObjectWorldAngleX.htm
GetObjectWorldAngleY|Reference/3D/GetObjectWorldAngleY.htm
GetObjectWorldAngleZ|Reference/3D/GetObjectWorldAngleZ.htm
GetObjectWorldQuatW|Reference/3D/GetObjectWorldQuatW.htm
GetObjectWorldQuatX|Reference/3D/GetObjectWorldQuatX.htm
GetObjectWorldQuatY|Reference/3D/GetObjectWorldQuatY.htm
GetObjectWorldQuatZ|Reference/3D/GetObjectWorldQuatZ.htm
GetObjectWorldX|Reference/3D/GetObjectWorldX.htm
GetObjectWorldY|Reference/3D/GetObjectWorldY.htm
GetObjectWorldZ|Reference/3D/GetObjectWorldZ.htm
GetObjectX|Reference/3D/GetObjectX.htm
GetObjectY|Reference/3D/GetObjectY.htm
GetObjectZ|Reference/3D/GetObjectZ.htm
GetScreenXFrom3D|Reference/3D/GetScreenXFrom3D.htm
GetScreenYFrom3D|Reference/3D/GetScreenYFrom3D.htm
InstanceObject|Reference/3D/InstanceObject.htm
InstanceObject|Reference/3D/InstanceObject.htm
LoadObject|Reference/3D/LoadObject.htm
LoadObject|Reference/3D/LoadObject.htm
LoadObject|Reference/3D/LoadObject.htm
LoadObject|Reference/3D/LoadObject.htm
LoadObjectWithChildren|Reference/3D/LoadObjectWithChildren.htm
LoadObjectWithChildren|Reference/3D/LoadObjectWithChildren.htm
MoveObjectLocalX|Reference/3D/MoveObjectLocalX.htm
MoveObjectLocalY|Reference/3D/MoveObjectLocalY.htm
MoveObjectLocalZ|Reference/3D/MoveObjectLocalZ.htm
ObjectRayCast|Reference/3D/ObjectRayCast.htm
ObjectSphereCast|Reference/3D/ObjectSphereCast.htm
ObjectSphereSlide|Reference/3D/ObjectSphereSlide.htm
PlayObjectAnimation|Reference/3D/PlayObjectAnimation.htm
ResetObjectAnimation|Reference/3D/ResetObjectAnimation.htm
RotateObjectGlobalX|Reference/3D/RotateObjectGlobalX.htm
RotateObjectGlobalY|Reference/3D/RotateObjectGlobalY.htm
RotateObjectGlobalZ|Reference/3D/RotateObjectGlobalZ.htm
RotateObjectLocalX|Reference/3D/RotateObjectLocalX.htm
RotateObjectLocalY|Reference/3D/RotateObjectLocalY.htm
RotateObjectLocalZ|Reference/3D/RotateObjectLocalZ.htm
SaveObject|Reference/3D/SaveObject.htm
SetObjectAlpha|Reference/3D/SetObjectAlpha.htm
SetObjectAlphaMask|Reference/3D/SetObjectAlphaMask.htm
SetObjectAnimationFrame|Reference/3D/SetObjectAnimationFrame.htm
SetObjectAnimationSpeed|Reference/3D/SetObjectAnimationSpeed.htm
SetObjectBlendModes|Reference/3D/SetObjectBlendModes.htm
SetObjectCollisionMode|Reference/3D/SetObjectCollisionMode.htm
SetObjectColor|Reference/3D/SetObjectColor.htm
SetObjectColorEmissive|Reference/3D/SetObjectColorEmissive.htm
SetObjectCullMode|Reference/3D/SetObjectCullMode.htm
SetObjectDepthBias|Reference/3D/SetObjectDepthBias.htm
SetObjectDepthRange|Reference/3D/SetObjectDepthRange.htm
SetObjectDepthReadMode|Reference/3D/SetObjectDepthReadMode.htm
SetObjectDepthWrite|Reference/3D/SetObjectDepthWrite.htm
SetObjectFogMode|Reference/3D/SetObjectFogMode.htm
SetObjectImage|Reference/3D/SetObjectImage.htm
SetObjectLightMap|Reference/3D/SetObjectLightMap.htm
SetObjectLightMode|Reference/3D/SetObjectLightMode.htm
SetObjectLookAt|Reference/3D/SetObjectLookAt.htm
SetObjectMeshNormalMapScale|Reference/3D/SetObjectMeshNormalMapScale.htm
SetObjectMeshUVOffset|Reference/3D/SetObjectMeshUVOffset.htm
SetObjectMeshUVScale|Reference/3D/SetObjectMeshUVScale.htm
SetObjectNormalMap|Reference/3D/SetObjectNormalMap.htm
SetObjectNormalMapScale|Reference/3D/SetObjectNormalMapScale.htm
SetObjectPosition|Reference/3D/SetObjectPosition.htm
SetObjectRotation|Reference/3D/SetObjectRotation.htm
SetObjectRotationQuat|Reference/3D/SetObjectRotationQuat.htm
SetObjectScale|Reference/3D/SetObjectScale.htm
SetObjectScalePermanent|Reference/3D/SetObjectScalePermanent.htm
SetObjectScreenCulling|Reference/3D/SetObjectScreenCulling.htm
SetObjectShader|Reference/3D/SetObjectShader.htm
SetObjectShaderConstantArrayByName|Reference/3D/SetObjectShaderConstantArrayByName.htm
SetObjectShaderConstantByName|Reference/3D/SetObjectShaderConstantByName.htm
SetObjectShaderConstantDefault|Reference/3D/SetObjectShaderConstantDefault.htm
SetObjectTransparency|Reference/3D/SetObjectTransparency.htm
SetObjectUVOffset|Reference/3D/SetObjectUVOffset.htm
SetObjectUVScale|Reference/3D/SetObjectUVScale.htm
SetObjectVisible|Reference/3D/SetObjectVisible.htm
StopObjectAnimation|Reference/3D/StopObjectAnimation.htm
GetSpriteCollision|Reference/Sprite/GetSpriteCollision.htm
GetSpriteDistance|Reference/Sprite/GetSpriteDistance.htm
GetSpriteDistancePoint1X|Reference/Sprite/GetSpriteDistancePoint1X.htm
GetSpriteDistancePoint1Y|Reference/Sprite/GetSpriteDistancePoint1Y.htm
GetSpriteDistancePoint2X|Reference/Sprite/GetSpriteDistancePoint2X.htm
GetSpriteDistancePoint2Y|Reference/Sprite/GetSpriteDistancePoint2Y.htm
GetSpriteInBox|Reference/Sprite/GetSpriteInBox.htm
GetSpriteInCircle|Reference/Sprite/GetSpriteInCircle.htm
GetPhysicsIslandCount|Reference/2DPhysics/GetPhysicsIslandCount.htm
GetPhysicsSolveTime|Reference/2DPhysics/GetPhysicsSolveTime.htm
SetPhysicsCCD|Reference/2DPhysics/SetPhysicsCCD.htm
SetPhysicsDebugOff|Reference/2DPhysics/SetPhysicsDebugOff.htm
SetPhysicsDebugOn|Reference/2DPhysics/SetPhysicsDebugOn.htm
SetPhysicsSleeping|Reference/2DPhysics/SetPhysicsSleeping.htm
SetPhysicsThreading|Reference/2DPhysics/SetPhysicsThreading.htm
GetErrorMode|Reference/Error/GetErrorMode.htm
GetErrorOccurred|Reference/Error/GetErrorOccurred.htm
GetLastError|Reference/Error/GetLastError.htm
Log|Reference/Error/Log.htm
SetErrorMode|Reference/Error/SetErrorMode.htm
CreateImageFromMemblock|Reference/Memblock/CreateImageFromMemblock.htm
CreateImageFromMemblock|Reference/Memblock/CreateImageFromMemblock.htm
CreateImageFromPNGMemblock|Reference/Memblock/CreateImageFromPNGMemblock.htm
CreateImageFromPNGMemblock|Reference/Memblock/CreateImageFromPNGMemblock.htm
CreateMemblockFromImage|Reference/Memblock/CreateMemblockFromImage.htm
CreateMemblockFromImage|Reference/Memblock/CreateMemblockFromImage.htm
GetObjectCastShadowMode|Reference/3D/GetObjectCastShadowMode.htm
GetObjectReceiveShadowMode|Reference/3D/GetObjectReceiveShadowMode.htm
GetShadowMappingMode|Reference/3D/GetShadowMappingMode.htm
GetShadowMappingSupported|Reference/3D/GetShadowMappingSupported.htm
SetObjectCastShadow|Reference/3D/SetObjectCastShadow.htm
SetObjectReceiveShadow|Reference/3D/SetObjectReceiveShadow.htm
SetShadowBias|Reference/3D/SetShadowBias.htm
SetShadowCascadeValues|Reference/3D/SetShadowCascadeValues.htm
SetShadowLightStepSize|Reference/3D/SetShadowLightStepSize.htm
SetShadowMapSize|Reference/3D/SetShadowMapSize.htm
SetShadowMappingMode|Reference/3D/SetShadowMappingMode.htm
SetShadowRange|Reference/3D/SetShadowRange.htm
SetShadowSmoothing|Reference/3D/SetShadowSmoothing.htm
ActivateSmartWatch|Reference/Extras/ActivateSmartWatch.htm
GetSmartWatchState|Reference/Extras/GetSmartWatchState.htm
ReceiveSmartWatchData|Reference/Extras/ReceiveSmartWatchData.htm
SendSmartWatchData|Reference/Extras/SendSmartWatchData.htm
CompleteRawJoystickDetection|Reference/Input-Raw/CompleteRawJoystickDetection.htm
GetRawJoystickButtonPressed|Reference/Input-Raw/GetRawJoystickButtonPressed.htm
GetRawJoystickButtonReleased|Reference/Input-Raw/GetRawJoystickButtonReleased.htm
GetRawJoystickButtonState|Reference/Input-Raw/GetRawJoystickButtonState.htm
GetRawJoystickConnected|Reference/Input-Raw/GetRawJoystickConnected.htm
GetRawJoystickExists|Reference/Input-Raw/GetRawJoystickExists.htm
GetRawJoystickName|Reference/Input-Raw/GetRawJoystickName.htm
GetRawJoystickPOV|Reference/Input-Raw/GetRawJoystickPOV.htm
GetRawJoystickRX|Reference/Input-Raw/GetRawJoystickRX.htm
GetRawJoystickRY|Reference/Input-Raw/GetRawJoystickRY.htm
GetRawJoystickRZ|Reference/Input-Raw/GetRawJoystickRZ.htm
GetRawJoystickSlider|Reference/Input-Raw/GetRawJoystickSlider.htm
GetRawJoystickX|Reference/Input-Raw/GetRawJoystickX.htm
GetRawJoystickY|Reference/Input-Raw/GetRawJoystickY.htm
GetRawJoystickZ|Reference/Input-Raw/GetRawJoystickZ.htm
SetRawJoystickDeadZone|Reference/Input-Raw/SetRawJoystickDeadZone.htm
CreatePhysicsForce|Reference/2DPhysics/CreatePhysicsForce.htm
DeletePhysicsForce|Reference/2DPhysics/DeletePhysicsForce.htm
SetPhysicsForcePosition|Reference/2DPhysics/SetPhysicsForcePosition.htm
SetPhysicsForcePower|Reference/2DPhysics/SetPhysicsForcePower.htm
SetPhysicsForceRange|Reference/2DPhysics/SetPhysicsForceRange.htm
DeleteNetworkClient|Reference/Multiplayer/DeleteNetworkClient.htm
GetDeviceIP|Reference/Multiplayer/GetDeviceIP.htm
GetDeviceIPv6|Reference/Multiplayer/GetDeviceIPv6.htm
GetNetworkClientDisconnected|Reference/Multiplayer/GetNetworkClientDisconnected.htm
GetNetworkClientFloat|Reference/Multiplayer/GetNetworkClientFloat.htm
GetNetworkClientIP|Reference/Multiplayer/GetNetworkClientIP.htm
GetNetworkClientInteger|Reference/Multiplayer/GetNetworkClientInteger.htm
GetNetworkClientName|Reference/Multiplayer/GetNetworkClientName.htm
GetNetworkClientPing|Reference/Multiplayer/GetNetworkClientPing.htm
GetNetworkClientUserData|Reference/Multiplayer/GetNetworkClientUserData.htm
GetNetworkFirstClient|Reference/Multiplayer/GetNetworkFirstClient.htm
GetNetworkMyClientID|Reference/Multiplayer/GetNetworkMyClientID.htm
GetNetworkNextClient|Reference/Multiplayer/GetNetworkNextClient.htm
GetNetworkNumClients|Reference/Multiplayer/GetNetworkNumClients.htm
GetNetworkServerID|Reference/Multiplayer/GetNetworkServerID.htm
GetNetworkServerIP|Reference/Multiplayer/GetNetworkServerIP.htm
KickNetworkClient|Reference/Multiplayer/KickNetworkClient.htm
SetNetworkClientUserData|Reference/Multiplayer/SetNetworkClientUserData.htm
SetNetworkLocalFloat|Reference/Multiplayer/SetNetworkLocalFloat.htm
SetNetworkLocalFloat|Reference/Multiplayer/SetNetworkLocalFloat.htm
SetNetworkLocalInteger|Reference/Multiplayer/SetNetworkLocalInteger.htm
SetNetworkLocalInteger|Reference/Multiplayer/SetNetworkLocalInteger.htm
OpenToWrite|Reference/File/OpenToWrite.htm
OpenToWrite|Reference/File/OpenToWrite.htm
OpenToWrite|Reference/File/OpenToWrite.htm
OpenToWrite|Reference/File/OpenToWrite.htm
WriteByte|Reference/File/WriteByte.htm
WriteFloat|Reference/File/WriteFloat.htm
WriteInteger|Reference/File/WriteInteger.htm
WriteLine|Reference/File/WriteLine.htm
WriteString|Reference/File/WriteString.htm
WriteString2|Reference/File/WriteString2.htm
GetInAppPurchaseAvailable|Reference/Extras/GetInAppPurchaseAvailable.htm
GetInAppPurchaseAvailable2|Reference/Extras/GetInAppPurchaseAvailable2.htm
GetInAppPurchaseDescription|Reference/Extras/GetInAppPurchaseDescription.htm
GetInAppPurchaseLocalPrice|Reference/Extras/GetInAppPurchaseLocalPrice.htm
GetInAppPurchaseSignature|Reference/Extras/GetInAppPurchaseSignature.htm
GetInAppPurchaseState|Reference/Extras/GetInAppPurchaseState.htm
GetInAppPurchaseToken|Reference/Extras/GetInAppPurchaseToken.htm
InAppPurchaseActivate|Reference/Extras/InAppPurchaseActivate.htm
InAppPurchaseAddProductID|Reference/Extras/InAppPurchaseAddProductID.htm
InAppPurchaseResetPurchase|Reference/Extras/InAppPurchaseResetPurchase.htm
InAppPurchaseRestore|Reference/Extras/InAppPurchaseRestore.htm
InAppPurchaseSetKeys|Reference/Extras/InAppPurchaseSetKeys.htm
InAppPurchaseSetTitle|Reference/Extras/InAppPurchaseSetTitle.htm
InAppPurchaseSetup|Reference/Extras/InAppPurchaseSetup.htm
CreateTweenCamera|Reference/Tweening/CreateTweenCamera.htm
CreateTweenCamera|Reference/Tweening/CreateTweenCamera.htm
GetTweenCameraExists|Reference/Tweening/GetTweenCameraExists.htm
GetTweenCameraPlaying|Reference/Tweening/GetTweenCameraPlaying.htm
PauseTweenCamera|Reference/Tweening/PauseTweenCamera.htm
PlayTweenCamera|Reference/Tweening/PlayTweenCamera.htm
ResumeTweenCamera|Reference/Tweening/ResumeTweenCamera.htm
SetTweenCameraAngleX|Reference/Tweening/SetTweenCameraAngleX.htm
SetTweenCameraAngleY|Reference/Tweening/SetTweenCameraAngleY.htm
SetTweenCameraAngleZ|Reference/Tweening/SetTweenCameraAngleZ.htm
SetTweenCameraFOV|Reference/Tweening/SetTweenCameraFOV.htm
SetTweenCameraX|Reference/Tweening/SetTweenCameraX.htm
SetTweenCameraY|Reference/Tweening/SetTweenCameraY.htm
SetTweenCameraZ|Reference/Tweening/SetTweenCameraZ.htm
StopTweenCamera|Reference/Tweening/StopTweenCamera.htm
SetPhysicsGravity|Reference/2DPhysics/SetPhysicsGravity.htm
SetPhysicsMaxPolygonPoints|Reference/2DPhysics/SetPhysicsMaxPolygonPoints.htm
SetPhysicsScale|Reference/2DPhysics/SetPhysicsScale.htm
SetPhysicsWallBottom|Reference/2DPhysics/SetPhysicsWallBottom.htm
SetPhysicsWallLeft|Reference/2DPhysics/SetPhysicsWallLeft.htm
SetPhysicsWallRight|Reference/2DPhysics/SetPhysicsWallRight.htm
SetPhysicsWallTop|Reference/2DPhysics/SetPhysicsWallTop.htm
IsScreenRecording|Reference/Video/IsScreenRecording.htm
StartScreenRecording|Reference/Video/StartScreenRecording.htm
StopScreenRecording|Reference/Video/StopScreenRecording.htm
StepPhysics|Reference/Core/StepPhysics.htm
Update|Reference/Core/Update.htm
Update2D|Reference/Core/Update2D.htm
Update3D|Reference/Core/Update3D.htm
OverrideConsentChartboost|Reference/Advert/OverrideConsentChartboost.htm
SetChartboostDetails|Reference/Advert/SetChartboostDetails.htm
ShowFullscreenAdvertChartboost|Reference/Advert/ShowFullscreenAdvertChartboost.htm
DeleteVideo|Reference/Video/DeleteVideo.htm
GetVideoDuration|Reference/Video/GetVideoDuration.htm
GetVideoHeight|Reference/Video/GetVideoHeight.htm
GetVideoPlaying|Reference/Video/GetVideoPlaying.htm
GetVideoPosition|Reference/Video/GetVideoPosition.htm
GetVideoWidth|Reference/Video/GetVideoWidth.htm
LoadVideo|Reference/Video/LoadVideo.htm
PauseVideo|Reference/Video/PauseVideo.htm
PlayVideo|Reference/Video/PlayVideo.htm
PlayVideoToImage|Reference/Video/PlayVideoToImage.htm
SetVideoDimensions|Reference/Video/SetVideoDimensions.htm
SetVideoPosition|Reference/Video/SetVideoPosition.htm
SetVideoVolume|Reference/Video/SetVideoVolume.htm
StopVideo|Reference/Video/StopVideo.htm
Create3DPhysicsCharacterController|Reference/3DPhysics/Create3DPhysicsCharacterController.htm
Crouch3DPhysicsCharacterController|Reference/3DPhysics/Crouch3DPhysicsCharacterController.htm
Debug3DPhysicsCharacterController|Reference/3DPhysics/Debug3DPhysicsCharacterController.htm
Delete3DPhysicsCharacterController|Reference/3DPhysics/Delete3DPhysicsCharacterController.htm
Get3DPhysicsCharacterControllerExists|Reference/3DPhysics/Get3DPhysicsCharacterControllerExists.htm
Get3DPhysicsCharacterControllerGravity|Reference/3DPhysics/Get3DPhysicsCharacterControllerGravity.htm
Get3DPhysicsCharacterControllerMaxSlope|Reference/3DPhysics/Get3DPhysicsCharacterControllerMaxSlope.htm
Jump3DPhysicsCharacterController|Reference/3DPhysics/Jump3DPhysicsCharacterController.htm
Move3DPhysicsCharacterController|Reference/3DPhysics/Move3DPhysicsCharacterController.htm
Move3DPhysicsCharacterController|Reference/3DPhysics/Move3DPhysicsCharacterController.htm
Rotate3DPhysicsCharacterController|Reference/3DPhysics/Rotate3DPhysicsCharacterController.htm
Set3DPhysicsCharacterControllerFallSpeed|Reference/3DPhysics/Set3DPhysicsCharacterControllerFallSpeed.htm
Set3DPhysicsCharacterControllerGravity|Reference/3DPhysics/Set3DPhysicsCharacterControllerGravity.htm
Set3DPhysicsCharacterControllerJumpSpeed|Reference/3DPhysics/Set3DPhysicsCharacterControllerJumpSpeed.htm
Set3DPhysicsCharacterControllerMaxSlope|Reference/3DPhysics/Set3DPhysicsCharacterControllerMaxSlope.htm
Set3DPhysicsCharacterControllerPosition|Reference/3DPhysics/Set3DPhysicsCharacterControllerPosition.htm
Set3DPhysicsCharacterControllerStepHeight|Reference/3DPhysics/Set3DPhysicsCharacterControllerStepHeight.htm
Stand3DPhysicsCharacterController|Reference/3DPhysics/Stand3DPhysicsCharacterController.htm
AddObjectMeshFromMemblock|Reference/Memblock/AddObjectMeshFromMemblock.htm
CreateMemblockFromObjectMesh|Reference/Memblock/CreateMemblockFromObjectMesh.htm
CreateMemblockFromObjectMesh|Reference/Memblock/CreateMemblockFromObjectMesh.htm
CreateObjectFromMeshMemblock|Reference/Memblock/CreateObjectFromMeshMemblock.htm
CreateObjectFromMeshMemblock|Reference/Memblock/CreateObjectFromMeshMemblock.htm
GetMeshMemblockVertexAlpha|Reference/Memblock/GetMeshMemblockVertexAlpha.htm
GetMeshMemblockVertexBlue|Reference/Memblock/GetMeshMemblockVertexBlue.htm
GetMeshMemblockVertexGreen|Reference/Memblock/GetMeshMemblockVertexGreen.htm
GetMeshMemblockVertexNormalX|Reference/Memblock/GetMeshMemblockVertexNormalX.htm
GetMeshMemblockVertexNormalY|Reference/Memblock/GetMeshMemblockVertexNormalY.htm
GetMeshMemblockVertexNormalZ|Reference/Memblock/GetMeshMemblockVertexNormalZ.htm
GetMeshMemblockVertexRed|Reference/Memblock/GetMeshMemblockVertexRed.htm
GetMeshMemblockVertexU|Reference/Memblock/GetMeshMemblockVertexU.htm
GetMeshMemblockVertexV|Reference/Memblock/GetMeshMemblockVertexV.htm
GetMeshMemblockVertexX|Reference/Memblock/GetMeshMemblockVertexX.htm
GetMeshMemblockVertexY|Reference/Memblock/GetMeshMemblockVertexY.htm
GetMeshMemblockVertexZ|Reference/Memblock/GetMeshMemblockVertexZ.htm
SetMeshMemblockVertexColor|Reference/Memblock/SetMeshMemblockVertexColor.htm
SetMeshMemblockVertexNormal|Reference/Memblock/SetMeshMemblockVertexNormal.htm
SetMeshMemblockVertexPosition|Reference/Memblock/SetMeshMemblockVertexPosition.htm
SetMeshMemblockVertexUV|Reference/Memblock/SetMeshMemblockVertexUV.htm
SetObjectMeshFromMemblock|Reference/Memblock/SetObjectMeshFromMemblock.htm
Add3DPhysicsRagDollBone|Reference/3DPhysics/Add3DPhysicsRagDollBone.htm
Add3DPhysicsRagDollHingeJoint|Reference/3DPhysics/Add3DPhysicsRagDollHingeJoint.htm
Add3DPhysicsRagDollTwistJoint|Reference/3DPhysics/Add3DPhysicsRagDollTwistJoint.htm
AssignTo3DPhysicsRagDollBoneObjectBone|Reference/3DPhysics/AssignTo3DPhysicsRagDollBoneObjectBone.htm
Create3DPhysicsRagDoll|Reference/3DPhysics/Create3DPhysicsRagDoll.htm
Delete3DPhysicsRagdoll|Reference/3DPhysics/Delete3DPhysicsRagdoll.htm
Finalize3DPhysicsRagDoll|Reference/3DPhysics/Finalize3DPhysicsRagDoll.htm
Get3DPhysicsRagdollExist|Reference/3DPhysics/Get3DPhysicsRagdollExist.htm
Get3DPhysicsRagdollFromBoneObject|Reference/3DPhysics/Get3DPhysicsRagdollFromBoneObject.htm
Is3dPhysicsRagdollStatic|Reference/3DPhysics/Is3dPhysicsRagdollStatic.htm
Set3DPhysicsRagdollBonesVisible|Reference/3DPhysics/Set3DPhysicsRagdollBonesVisible.htm
Set3DPhysicsRagdollDamping|Reference/3DPhysics/Set3DPhysicsRagdollDamping.htm
Set3DPhysicsRagdollDeactivation|Reference/3DPhysics/Set3DPhysicsRagdollDeactivation.htm
Set3DPhysicsRagdollDeactivationTime|Reference/3DPhysics/Set3DPhysicsRagdollDeactivationTime.htm
Set3DPhysicsRagdollSleepingThresholds|Reference/3DPhysics/Set3DPhysicsRagdollSleepingThresholds.htm
Set3DphysicsRagdollStatic|Reference/3DPhysics/Set3DphysicsRagdollStatic.htm
GetContactSpriteID1|Reference/2DPhysics/GetContactSpriteID1.htm
GetContactSpriteID2|Reference/2DPhysics/GetContactSpriteID2.htm
GetContactWorldX|Reference/2DPhysics/GetContactWorldX.htm
GetContactWorldY|Reference/2DPhysics/GetContactWorldY.htm
GetFirstContact|Reference/2DPhysics/GetFirstContact.htm
GetNextContact|Reference/2DPhysics/GetNextContact.htm
GetSpriteContactSpriteID2|Reference/2DPhysics/GetSpriteContactSpriteID2.htm
GetSpriteContactWorldX|Reference/2DPhysics/GetSpriteContactWorldX.htm
GetSpriteContactWorldY|Reference/2DPhysics/GetSpriteContactWorldY.htm
GetSpriteFirstContact|Reference/2DPhysics/GetSpriteFirstContact.htm
GetSpriteNextContact|Reference/2DPhysics/GetSpriteNextContact.htm
Create3DPhysicsRay|Reference/3DPhysics/Create3DPhysicsRay.htm
Delete3DPhysicsRay|Reference/3DPhysics/Delete3DPhysicsRay.htm
Get3DPhysicsRayCastClosestContactPosition|Reference/3DPhysics/Get3DPhysicsRayCastClosestContactPosition.htm
Get3DPhysicsRayCastClosestObjectHit|Reference/3DPhysics/Get3DPhysicsRayCastClosestObjectHit.htm
Get3DPhysicsRayCastContactPosition|Reference/3DPhysics/Get3DPhysicsRayCastContactPosition.htm
Get3DPhysicsRayCastFraction|Reference/3DPhysics/Get3DPhysicsRayCastFraction.htm
Get3DPhysicsRayCastNormalVector|Reference/3DPhysics/Get3DPhysicsRayCastNormalVector.htm
Get3DPhysicsRayCastNumHits|Reference/3DPhysics/Get3DPhysicsRayCastNumHits.htm
Get3DPhysicsRayCastObjectHit|Reference/3DPhysics/Get3DPhysicsRayCastObjectHit.htm
Ray3DPhysicsExist|Reference/3DPhysics/Ray3DPhysicsExist.htm
RayCast3DPhysics|Reference/3DPhysics/RayCast3DPhysics.htm
RayCast3DPhysicsObject|Reference/3DPhysics/RayCast3DPhysicsObject.htm
SphereCast3DPhysics|Reference/3DPhysics/SphereCast3DPhysics.htm
SphereCast3DPhysicsObject|Reference/3DPhysics/SphereCast3DPhysicsObject.htm
GetRayCastFraction|Reference/2DPhysics/GetRayCastFraction.htm
GetRayCastNormalX|Reference/2DPhysics/GetRayCastNormalX.htm
GetRayCastNormalY|Reference/2DPhysics/GetRayCastNormalY.htm
GetRayCastSpriteID|Reference/2DPhysics/GetRayCastSpriteID.htm
GetRayCastX|Reference/2DPhysics/GetRayCastX.htm
GetRayCastY|Reference/2DPhysics/GetRayCastY.htm
PhysicsRayCast|Reference/2DPhysics/PhysicsRayCast.htm
PhysicsRayCastCategory|Reference/2DPhysics/PhysicsRayCastCategory.htm
PhysicsRayCastGroup|Reference/2DPhysics/PhysicsRayCastGroup.htm
SpriteRayCast|Reference/2DPhysics/SpriteRayCast.htm
SpriteRayCastCategory|Reference/2DPhysics/SpriteRayCastCategory.htm
SpriteRayCastGroup|Reference/2DPhysics/SpriteRayCastGroup.htm
SpriteRayCastSingle|Reference/2DPhysics/SpriteRayCastSingle.htm
CreateBroadcastListener|Reference/Multiplayer/CreateBroadcastListener.htm
CreateBroadcastListener|Reference/Multiplayer/CreateBroadcastListener.htm
DeleteBroadcastListener|Reference/Multiplayer/DeleteBroadcastListener.htm
GetBroadcastMessage|Reference/Multiplayer/GetBroadcastMessage.htm
Create3DParticles|Reference/3DParticles/Create3DParticles.htm
Create3DParticles|Reference/3DParticles/Create3DParticles.htm
Delete3DParticles|Reference/3DParticles/Delete3DParticles.htm
ClearURLSchemeText|Reference/Core/ClearURLSchemeText.htm
DownloadExpansionFile|Reference/Core/DownloadExpansionFile.htm
GetAppInstalled|Reference/Core/GetAppInstalled.htm
GetAppName|Reference/Core/GetAppName.htm
GetAppPackageName|Reference/Core/GetAppPackageName.htm
GetDeviceBaseName|Reference/Core/GetDeviceBaseName.htm
GetDeviceID|Reference/Core/GetDeviceID.htm
GetDeviceLanguage|Reference/Core/GetDeviceLanguage.htm
GetDeviceName|Reference/Core/GetDeviceName.htm
GetDeviceNetworkType|Reference/Core/GetDeviceNetworkType.htm
GetDevicePlatform|Reference/Core/GetDevicePlatform.htm
GetDeviceType|Reference/Core/GetDeviceType.htm
GetExpansionFileError|Reference/Core/GetExpansionFileError.htm
GetExpansionFileProgress|Reference/Core/GetExpansionFileProgress.htm
GetExpansionFileState|Reference/Core/GetExpansionFileState.htm
GetFrameTime|Reference/Core/GetFrameTime.htm
GetMilliseconds|Reference/Core/GetMilliseconds.htm
GetNumProcessors|Reference/Core/GetNumProcessors.htm
GetSeconds|Reference/Core/GetSeconds.htm
GetStorageRemaining|Reference/Core/GetStorageRemaining.htm
GetStorageTotal|Reference/Core/GetStorageTotal.htm
GetURLSchemeText|Reference/Core/GetURLSchemeText.htm
Message|Reference/Core/Message.htm
ResetTimer|Reference/Core/ResetTimer.htm
SetAntialiasMode|Reference/Core/SetAntialiasMode.htm
SetDefaultMagFilter|Reference/Core/SetDefaultMagFilter.htm
SetDefaultMinFilter|Reference/Core/SetDefaultMinFilter.htm
SetDefaultWrapU|Reference/Core/SetDefaultWrapU.htm
SetDefaultWrapV|Reference/Core/SetDefaultWrapV.htm
SetExpansionFileKey|Reference/Core/SetExpansionFileKey.htm
SetExpansionFileVersion|Reference/Core/SetExpansionFileVersion.htm
SetGenerateMipmaps|Reference/Core/SetGenerateMipmaps.htm
SetSleepMode|Reference/Core/SetSleepMode.htm
SetSortCreated|Reference/Core/SetSortCreated.htm
SetSortDepth|Reference/Core/SetSortDepth.htm
SetSortTextures|Reference/Core/SetSortTextures.htm
SetSortTransparentDepth|Reference/Core/SetSortTransparentDepth.htm
SetWindowTitle|Reference/Core/SetWindowTitle.htm
Sha1|Reference/Core/Sha1.htm
Sha256|Reference/Core/Sha256.htm
Sha512|Reference/Core/Sha512.htm
Sleep|Reference/Core/Sleep.htm
Timer|Reference/Core/Timer.htm
FixCameraToObject|Reference/3D/FixCameraToObject.htm
GetCameraAngleX|Reference/3D/GetCameraAngleX.htm
GetCameraAngleY|Reference/3D/GetCameraAngleY.htm
GetCameraAngleZ|Reference/3D/GetCameraAngleZ.htm
GetCameraFOV|Reference/3D/GetCameraFOV.htm
GetCameraQuatW|Reference/3D/GetCameraQuatW.htm
GetCameraQuatX|Reference/3D/GetCameraQuatX.htm
GetCameraQuatY|Reference/3D/GetCameraQuatY.htm
GetCameraQuatZ|Reference/3D/GetCameraQuatZ.htm
GetCameraWorldAngleX|Reference/3D/GetCameraWorldAngleX.htm
GetCameraWorldAngleY|Reference/3D/GetCameraWorldAngleY.htm
GetCameraWorldAngleZ|Reference/3D/GetCameraWorldAngleZ.htm
GetCameraWorldQuatW|Reference/3D/GetCameraWorldQuatW.htm
GetCameraWorldQuatX|Reference/3D/GetCameraWorldQuatX.htm
GetCameraWorldQuatY|Reference/3D/GetCameraWorldQuatY.htm
GetCameraWorldQuatZ|Reference/3D/GetCameraWorldQuatZ.htm
GetCameraWorldX|Reference/3D/GetCameraWorldX.htm
GetCameraWorldY|Reference/3D/GetCameraWorldY.htm
GetCameraWorldZ|Reference/3D/GetCameraWorldZ.htm
GetCameraX|Reference/3D/GetCameraX.htm
GetCameraY|Reference/3D/GetCameraY.htm
GetCameraZ|Reference/3D/GetCameraZ.htm
MoveCameraLocalX|Reference/3D/MoveCameraLocalX.htm
MoveCameraLocalY|Reference/3D/MoveCameraLocalY.htm
MoveCameraLocalZ|Reference/3D/MoveCameraLocalZ.htm
RotateCameraGlobalX|Reference/3D/RotateCameraGlobalX.htm
RotateCameraGlobalY|Reference/3D/RotateCameraGlobalY.htm
RotateCameraGlobalZ|Reference/3D/RotateCameraGlobalZ.htm
RotateCameraLocalX|Reference/3D/RotateCameraLocalX.htm
RotateCameraLocalY|Reference/3D/RotateCameraLocalY.htm
RotateCameraLocalZ|Reference/3D/RotateCameraLocalZ.htm
SetCameraAspect|Reference/3D/SetCameraAspect.htm
SetCameraBounds|Reference/3D/SetCameraBounds.htm
SetCameraFOV|Reference/3D/SetCameraFOV.htm
SetCameraLookAt|Reference/3D/SetCameraLookAt.htm
SetCameraOffCenter|Reference/3D/SetCameraOffCenter.htm
SetCameraOrthoWidth|Reference/3D/SetCameraOrthoWidth.htm
SetCameraPosition|Reference/3D/SetCameraPosition.htm
SetCameraRange|Reference/3D/SetCameraRange.htm
SetCameraRotation|Reference/3D/SetCameraRotation.htm
SetCameraRotationQuat|Reference/3D/SetCameraRotationQuat.htm
ClearTweenCustom|Reference/Tweening/ClearTweenCustom.htm
CreateTweenCustom|Reference/Tweening/CreateTweenCustom.htm
CreateTweenCustom|Reference/Tweening/CreateTweenCustom.htm
GetTweenCustomEndTime|Reference/Tweening/GetTweenCustomEndTime.htm
GetTweenCustomExists|Reference/Tweening/GetTweenCustomExists.htm
GetTweenCustomFloat1|Reference/Tweening/GetTweenCustomFloat1.htm
GetTweenCustomFloat2|Reference/Tweening/GetTweenCustomFloat2.htm
GetTweenCustomFloat3|Reference/Tweening/GetTweenCustomFloat3.htm
GetTweenCustomFloat4|Reference/Tweening/GetTweenCustomFloat4.htm
GetTweenCustomInteger1|Reference/Tweening/GetTweenCustomInteger1.htm
GetTweenCustomInteger2|Reference/Tweening/GetTweenCustomInteger2.htm
GetTweenCustomInteger3|Reference/Tweening/GetTweenCustomInteger3.htm
GetTweenCustomInteger4|Reference/Tweening/GetTweenCustomInteger4.htm
GetTweenCustomPlaying|Reference/Tweening/GetTweenCustomPlaying.htm
GetTweenCustomTime|Reference/Tweening/GetTweenCustomTime.htm
PauseTweenCustom|Reference/Tweening/PauseTweenCustom.htm
PlayTweenCustom|Reference/Tweening/PlayTweenCustom.htm
ResumeTweenCustom|Reference/Tweening/ResumeTweenCustom.htm
SetTweenCustomFloat1|Reference/Tweening/SetTweenCustomFloat1.htm
SetTweenCustomFloat2|Reference/Tweening/SetTweenCustomFloat2.htm
SetTweenCustomFloat3|Reference/Tweening/SetTweenCustomFloat3.htm
SetTweenCustomFloat4|Reference/Tweening/SetTweenCustomFloat4.htm
SetTweenCustomInteger1|Reference/Tweening/SetTweenCustomInteger1.htm
SetTweenCustomInteger2|Reference/Tweening/SetTweenCustomInteger2.htm
SetTweenCustomInteger3|Reference/Tweening/SetTweenCustomInteger3.htm
SetTweenCustomInteger4|Reference/Tweening/SetTweenCustomInteger4.htm
StopTweenCustom|Reference/Tweening/StopTweenCustom.htm
GetObjectMeshName|Reference/3D/GetObjectMeshName.htm
GetObjectMeshPSSource|Reference/3D/GetObjectMeshPSSource.htm
GetObjectMeshVSSource|Reference/3D/GetObjectMeshVSSource.htm
GetObjectNumMeshes|Reference/3D/GetObjectNumMeshes.htm
GetObjectNumTextures|Reference/3D/GetObjectNumTextures.htm
GetObjectTextureName|Reference/3D/GetObjectTextureName.htm
SetObjectMeshCollisionMode|Reference/3D/SetObjectMeshCollisionMode.htm
SetObjectMeshImage|Reference/3D/SetObjectMeshImage.htm
SetObjectMeshLightMap|Reference/3D/SetObjectMeshLightMap.htm
SetObjectMeshNormalMap|Reference/3D/SetObjectMeshNormalMap.htm
SetObjectMeshShader|Reference/3D/SetObjectMeshShader.htm
SetObjectMeshVisible|Reference/3D/SetObjectMeshVisible.htm
DrawSprite|Reference/Sprite/DrawSprite.htm
FixSpriteToScreen|Reference/Sprite/FixSpriteToScreen.htm
GetSpriteActive|Reference/Sprite/GetSpriteActive.htm
GetSpriteAngle|Reference/Sprite/GetSpriteAngle.htm
GetSpriteAngleRad|Reference/Sprite/GetSpriteAngleRad.htm
GetSpriteColorAlpha|Reference/Sprite/GetSpriteColorAlpha.htm
GetSpriteColorBlue|Reference/Sprite/GetSpriteColorBlue.htm
GetSpriteColorGreen|Reference/Sprite/GetSpriteColorGreen.htm
GetSpriteColorRed|Reference/Sprite/GetSpriteColorRed.htm
GetSpriteDepth|Reference/Sprite/GetSpriteDepth.htm
GetSpriteExists|Reference/Sprite/GetSpriteExists.htm
GetSpriteFlippedH|Reference/Sprite/GetSpriteFlippedH.htm
GetSpriteFlippedV|Reference/Sprite/GetSpriteFlippedV.htm
GetSpriteGroup|Reference/Sprite/GetSpriteGroup.htm
GetSpriteHeight|Reference/Sprite/GetSpriteHeight.htm
GetSpriteHit|Reference/Sprite/GetSpriteHit.htm
GetSpriteHitCategory|Reference/Sprite/GetSpriteHitCategory.htm
GetSpriteHitGroup|Reference/Sprite/GetSpriteHitGroup.htm
GetSpriteHitTest|Reference/Sprite/GetSpriteHitTest.htm
GetSpriteImageID|Reference/Sprite/GetSpriteImageID.htm
GetSpriteInScreen|Reference/Sprite/GetSpriteInScreen.htm
GetSpriteOffsetX|Reference/Sprite/GetSpriteOffsetX.htm
GetSpriteOffsetY|Reference/Sprite/GetSpriteOffsetY.htm
GetSpritePixelFromX|Reference/Sprite/GetSpritePixelFromX.htm
GetSpritePixelFromY|Reference/Sprite/GetSpritePixelFromY.htm
GetSpriteScaleX|Reference/Sprite/GetSpriteScaleX.htm
GetSpriteScaleY|Reference/Sprite/GetSpriteScaleY.htm
GetSpriteTransparency|Reference/Sprite/GetSpriteTransparency.htm
GetSpriteVisible|Reference/Sprite/GetSpriteVisible.htm
GetSpriteWidth|Reference/Sprite/GetSpriteWidth.htm
GetSpriteX|Reference/Sprite/GetSpriteX.htm
GetSpriteXByOffset|Reference/Sprite/GetSpriteXByOffset.htm
GetSpriteXFromPixel|Reference/Sprite/GetSpriteXFromPixel.htm
GetSpriteXFromWorld|Reference/Sprite/GetSpriteXFromWorld.htm
GetSpriteY|Reference/Sprite/GetSpriteY.htm
GetSpriteYByOffset|Reference/Sprite/GetSpriteYByOffset.htm
GetSpriteYFromPixel|Reference/Sprite/GetSpriteYFromPixel.htm
GetSpriteYFromWorld|Reference/Sprite/GetSpriteYFromWorld.htm
GetWorldXFromSprite|Reference/Sprite/GetWorldXFromSprite.htm
GetWorldYFromSprite|Reference/Sprite/GetWorldYFromSprite.htm
ResetSpriteUV|Reference/Sprite/ResetSpriteUV.htm
SetSpriteActive|Reference/Sprite/SetSpriteActive.htm
SetSpriteAdditionalImage|Reference/Sprite/SetSpriteAdditionalImage.htm
SetSpriteAngle|Reference/Sprite/SetSpriteAngle.htm
SetSpriteAngleRad|Reference/Sprite/SetSpriteAngleRad.htm
SetSpriteColor|Reference/Sprite/SetSpriteColor.htm
SetSpriteColorAlpha|Reference/Sprite/SetSpriteColorAlpha.htm
SetSpriteColorBlue|Reference/Sprite/SetSpriteColorBlue.htm
SetSpriteColorGreen|Reference/Sprite/SetSpriteColorGreen.htm
SetSpriteColorRed|Reference/Sprite/SetSpriteColorRed.htm
SetSpriteDepth|Reference/Sprite/SetSpriteDepth.htm
SetSpriteFlip|Reference/Sprite/SetSpriteFlip.htm
SetSpriteImage|Reference/Sprite/SetSpriteImage.htm
SetSpriteImage|Reference/Sprite/SetSpriteImage.htm
SetSpriteOffset|Reference/Sprite/SetSpriteOffset.htm
SetSpritePosition|Reference/Sprite/SetSpritePosition.htm
SetSpritePositionByOffset|Reference/Sprite/SetSpritePositionByOffset.htm
SetSpriteScale|Reference/Sprite/SetSpriteScale.htm
SetSpriteScaleByOffset|Reference/Sprite/SetSpriteScaleByOffset.htm
SetSpriteScissor|Reference/Sprite/SetSpriteScissor.htm
SetSpriteShader|Reference/Sprite/SetSpriteShader.htm
SetSpriteSize|Reference/Sprite/SetSpriteSize.htm
SetSpriteSnap|Reference/Sprite/SetSpriteSnap.htm
SetSpriteTransparency|Reference/Sprite/SetSpriteTransparency.htm
SetSpriteUV|Reference/Sprite/SetSpriteUV.htm
SetSpriteUVBorder|Reference/Sprite/SetSpriteUVBorder.htm
SetSpriteUVOffset|Reference/Sprite/SetSpriteUVOffset.htm
SetSpriteUVScale|Reference/Sprite/SetSpriteUVScale.htm
SetSpriteVisible|Reference/Sprite/SetSpriteVisible.htm
SetSpriteX|Reference/Sprite/SetSpriteX.htm
SetSpriteY|Reference/Sprite/SetSpriteY.htm
GetJoystickX|Reference/Input/GetJoystickX.htm
GetJoystickY|Reference/Input/GetJoystickY.htm
SetJoystickDeadZone|Reference/Input/SetJoystickDeadZone.htm
SetJoystickScreenPosition|Reference/Input/SetJoystickScreenPosition.htm
RateApp|Reference/Extras/RateApp.htm
RateApp|Reference/Extras/RateApp.htm
RateApp|Reference/Extras/RateApp.htm
RequestAppReview|Reference/Extras/RequestAppReview.htm
GetAppRunning|Reference/Core/GetAppRunning.htm
RunApp|Reference/Core/RunApp.htm
ShareFile|Reference/Core/ShareFile.htm
ShareImage|Reference/Core/ShareImage.htm
ShareImageAndText|Reference/Core/ShareImageAndText.htm
ShareText|Reference/Core/ShareText.htm
TerminateApp|Reference/Core/TerminateApp.htm
ViewFile|Reference/Core/ViewFile.htm
Create3DPhysics6DOFJoint|Reference/3DPhysics/Create3DPhysics6DOFJoint.htm
Create3DPhysicsConeTwistJoint|Reference/3DPhysics/Create3DPhysicsConeTwistJoint.htm
Create3DPhysicsFixedJoint|Reference/3DPhysics/Create3DPhysicsFixedJoint.htm
Create3DPhysicsHingeJoint|Reference/3DPhysics/Create3DPhysicsHingeJoint.htm
Create3DPhysicsPickJoint|Reference/3DPhysics/Create3DPhysicsPickJoint.htm
Create3DPhysicsSliderJoint|Reference/3DPhysics/Create3DPhysicsSliderJoint.htm
Delete3DPhysicsJoint|Reference/3DPhysics/Delete3DPhysicsJoint.htm
Delete3DPhysicsPickJoint|Reference/3DPhysics/Delete3DPhysicsPickJoint.htm
Get3DPhysicsJointEnabled|Reference/3DPhysics/Get3DPhysicsJointEnabled.htm
Get3DPhysicsJointPositionVector|Reference/3DPhysics/Get3DPhysicsJointPositionVector.htm
Get3DPhysicsJointRotationVector|Reference/3DPhysics/Get3DPhysicsJointRotationVector.htm
Set3DPhysicsHingeJointMaxMotorImpulse|Reference/3DPhysics/Set3DPhysicsHingeJointMaxMotorImpulse.htm
Set3DPhysicsHingeJointMotorIsEnabled|Reference/3DPhysics/Set3DPhysicsHingeJointMotorIsEnabled.htm
Set3DPhysicsHingeJointMotorVelocity|Reference/3DPhysics/Set3DPhysicsHingeJointMotorVelocity.htm
Set3DPhysicsJointBreakingThreshold|Reference/3DPhysics/Set3DPhysicsJointBreakingThreshold.htm
Set3DPhysicsJointConeTwistLimits|Reference/3DPhysics/Set3DPhysicsJointConeTwistLimits.htm
Set3DPhysicsJointEnabled|Reference/3DPhysics/Set3DPhysicsJointEnabled.htm
Set3DPhysicsJointHingeLimits|Reference/3DPhysics/Set3DPhysicsJointHingeLimits.htm
Set3DPhysicsJointSliderAngularLimits|Reference/3DPhysics/Set3DPhysicsJointSliderAngularLimits.htm
Set3DPhysicsJointSliderLinearLimits|Reference/3DPhysics/Set3DPhysicsJointSliderLinearLimits.htm
Set3DPhysicsSliderJointMaxLinearMotorForce|Reference/3DPhysics/Set3DPhysicsSliderJointMaxLinearMotorForce.htm
Set3DPhysicsSliderJointPoweredLinearMotorIsEnabled|Reference/3DPhysics/Set3DPhysicsSliderJointPoweredLinearMotorIsEnabled.htm
Set3DPhysicsSliderJointTargetLinearMotorVelocity|Reference/3DPhysics/Set3DPhysicsSliderJointTargetLinearMotorVelocity.htm
Set3DPhysicsTwistJointMaxMotorImpulse|Reference/3DPhysics/Set3DPhysicsTwistJointMaxMotorImpulse.htm
Set3DPhysicsTwistJointMotorIsEnabled|Reference/3DPhysics/Set3DPhysicsTwistJointMotorIsEnabled.htm
Set3DPhysicsTwistJointMotorRotationTarget|Reference/3DPhysics/Set3DPhysicsTwistJointMotorRotationTarget.htm
Update3DPhysicsPickJoint|Reference/3DPhysics/Update3DPhysicsPickJoint.htm
CreateDistanceJoint|Reference/2DPhysics/CreateDistanceJoint.htm
CreateDistanceJoint|Reference/2DPhysics/CreateDistanceJoint.htm
CreateGearJoint|Reference/2DPhysics/CreateGearJoint.htm
CreateGearJoint|Reference/2DPhysics/CreateGearJoint.htm
CreateLineJoint|Reference/2DPhysics/CreateLineJoint.htm
CreateLineJoint|Reference/2DPhysics/CreateLineJoint.htm
CreateMouseJoint|Reference/2DPhysics/CreateMouseJoint.htm
CreateMouseJoint|Reference/2DPhysics/CreateMouseJoint.htm
CreatePrismaticJoint|Reference/2DPhysics/CreatePrismaticJoint.htm
CreatePrismaticJoint|Reference/2DPhysics/CreatePrismaticJoint.htm
CreatePulleyJoint|Reference/2DPhysics/CreatePulleyJoint.htm
CreatePulleyJoint2|Reference/2DPhysics/CreatePulleyJoint2.htm
CreateRevoluteJoint|Reference/2DPhysics/CreateRevoluteJoint.htm
CreateRevoluteJoint|Reference/2DPhysics/CreateRevoluteJoint.htm
CreateRopeJoint|Reference/2DPhysics/CreateRopeJoint.htm
CreateRopeJoint|Reference/2DPhysics/CreateRopeJoint.htm
CreateWeldJoint|Reference/2DPhysics/CreateWeldJoint.htm
CreateWeldJoint|Reference/2DPhysics/CreateWeldJoint.htm
DeleteJoint|Reference/2DPhysics/DeleteJoint.htm
FinishPulleyJoint|Reference/2DPhysics/FinishPulleyJoint.htm
GetJointExists|Reference/2DPhysics/GetJointExists.htm
GetJointReactionForceX|Reference/2DPhysics/GetJointReactionForceX.htm
GetJointReactionForceY|Reference/2DPhysics/GetJointReactionForceY.htm
GetJointReactionTorque|Reference/2DPhysics/GetJointReactionTorque.htm
SetJointDamping|Reference/2DPhysics/SetJointDamping.htm
SetJointLimitOff|Reference/2DPhysics/SetJointLimitOff.htm
SetJointLimitOn|Reference/2DPhysics/SetJointLimitOn.htm
SetJointMotorOff|Reference/2DPhysics/SetJointMotorOff.htm
SetJointMotorOn|Reference/2DPhysics/SetJointMotorOn.htm
SetJointMouseMaxForce|Reference/2DPhysics/SetJointMouseMaxForce.htm
SetJointMouseTarget|Reference/2DPhysics/SetJointMouseTarget.htm
GetRawAccelX|Reference/Input-Raw/GetRawAccelX.htm
GetRawAccelY|Reference/Input-Raw/GetRawAccelY.htm
GetRawAccelZ|Reference/Input-Raw/GetRawAccelZ.htm
GetRawGPSAltitude|Reference/Input-Raw/GetRawGPSAltitude.htm
GetRawGPSLatitude|Reference/Input-Raw/GetRawGPSLatitude.htm
GetRawGPSLongitude|Reference/Input-Raw/GetRawGPSLongitude.htm
GetRawGyroVelocityX|Reference/Input-Raw/GetRawGyroVelocityX.htm
GetRawGyroVelocityY|Reference/Input-Raw/GetRawGyroVelocityY.htm
GetRawGyroVelocityZ|Reference/Input-Raw/GetRawGyroVelocityZ.htm
GetRawLightLevel|Reference/Input-Raw/GetRawLightLevel.htm
GetRawMagneticX|Reference/Input-Raw/GetRawMagneticX.htm
GetRawMagneticY|Reference/Input-Raw/GetRawMagneticY.htm
GetRawMagneticZ|Reference/Input-Raw/GetRawMagneticZ.htm
GetRawProximityDistance|Reference/Input-Raw/GetRawProximityDistance.htm
GetRawRotationVectorW|Reference/Input-Raw/GetRawRotationVectorW.htm
GetRawRotationVectorW2|Reference/Input-Raw/GetRawRotationVectorW2.htm
GetRawRotationVectorX|Reference/Input-Raw/GetRawRotationVectorX.htm
GetRawRotationVectorX2|Reference/Input-Raw/GetRawRotationVectorX2.htm
GetRawRotationVectorY|Reference/Input-Raw/GetRawRotationVectorY.htm
GetRawRotationVectorY2|Reference/Input-Raw/GetRawRotationVectorY2.htm
GetRawRotationVectorZ|Reference/Input-Raw/GetRawRotationVectorZ.htm
GetRawRotationVectorZ2|Reference/Input-Raw/GetRawRotationVectorZ2.htm
StartGPSTracking|Reference/Input-Raw/StartGPSTracking.htm
StopGPSTracking|Reference/Input-Raw/StopGPSTracking.htm
ConnectSocket|Reference/Multiplayer/ConnectSocket.htm
ConnectSocket|Reference/Multiplayer/ConnectSocket.htm
DeleteSocket|Reference/Multiplayer/DeleteSocket.htm
FlushSocket|Reference/Multiplayer/FlushSocket.htm
GetSocketByte|Reference/Multiplayer/GetSocketByte.htm
GetSocketBytesAvailable|Reference/Multiplayer/GetSocketBytesAvailable.htm
GetSocketConnected|Reference/Multiplayer/GetSocketConnected.htm
GetSocketExists|Reference/Multiplayer/GetSocketExists.htm
GetSocketFloat|Reference/Multiplayer/GetSocketFloat.htm
GetSocketInteger|Reference/Multiplayer/GetSocketInteger.htm
GetSocketRemoteIP|Reference/Multiplayer/GetSocketRemoteIP.htm
GetSocketString|Reference/Multiplayer/GetSocketString.htm
SendSocketByte|Reference/Multiplayer/SendSocketByte.htm
SendSocketFloat|Reference/Multiplayer/SendSocketFloat.htm
SendSocketInteger|Reference/Multiplayer/SendSocketInteger.htm
SendSocketString|Reference/Multiplayer/SendSocketString.htm
Create3DPhysicsDynamicBody|Reference/3DPhysics/Create3DPhysicsDynamicBody.htm
Create3DPhysicsKinematicBody|Reference/3DPhysics/Create3DPhysicsKinematicBody.htm
Create3DPhysicsStaticBody|Reference/3DPhysics/Create3DPhysicsStaticBody.htm
Create3DPhysicsStaticPlane|Reference/3DPhysics/Create3DPhysicsStaticPlane.htm
Delete3DPhysicsBody|Reference/3DPhysics/Delete3DPhysicsBody.htm
Delete3DPhysicsStaticPlane|Reference/3DPhysics/Delete3DPhysicsStaticPlane.htm
GetObject3DPhysicsAngularDamp|Reference/3DPhysics/GetObject3DPhysicsAngularDamp.htm
GetObject3DPhysicsAngularSleepingThreshold|Reference/3DPhysics/GetObject3DPhysicsAngularSleepingThreshold.htm
GetObject3DPhysicsAngularVelocityX|Reference/3DPhysics/GetObject3DPhysicsAngularVelocityX.htm
GetObject3DPhysicsAngularVelocityY|Reference/3DPhysics/GetObject3DPhysicsAngularVelocityY.htm
GetObject3DPhysicsAngularVelocityZ|Reference/3DPhysics/GetObject3DPhysicsAngularVelocityZ.htm
GetObject3DPhysicsFriction|Reference/3DPhysics/GetObject3DPhysicsFriction.htm
GetObject3DPhysicsGroup|Reference/3DPhysics/GetObject3DPhysicsGroup.htm
GetObject3DPhysicsLinearDamp|Reference/3DPhysics/GetObject3DPhysicsLinearDamp.htm
GetObject3DPhysicsLinearSleepingThreshold|Reference/3DPhysics/GetObject3DPhysicsLinearSleepingThreshold.htm
GetObject3DPhysicsLinearVelocityX|Reference/3DPhysics/GetObject3DPhysicsLinearVelocityX.htm
GetObject3DPhysicsLinearVelocityY|Reference/3DPhysics/GetObject3DPhysicsLinearVelocityY.htm
GetObject3DPhysicsLinearVelocityZ|Reference/3DPhysics/GetObject3DPhysicsLinearVelocityZ.htm
GetObject3DPhysicsMask|Reference/3DPhysics/GetObject3DPhysicsMask.htm
GetObject3DPhysicsMass|Reference/3DPhysics/GetObject3DPhysicsMass.htm
GetObject3DPhysicsMaxLinearVelocity|Reference/3DPhysics/GetObject3DPhysicsMaxLinearVelocity.htm
GetObject3DPhysicsRestitution|Reference/3DPhysics/GetObject3DPhysicsRestitution.htm
GetObject3DPhysicsRollingFriction|Reference/3DPhysics/GetObject3DPhysicsRollingFriction.htm
Set3DPhysicsStaticPlanePosition|Reference/3DPhysics/Set3DPhysicsStaticPlanePosition.htm
Set3DPhysicsStaticPlaneRotation|Reference/3DPhysics/Set3DPhysicsStaticPlaneRotation.htm
SetObject3DPhysicsAngularVelocity|Reference/3DPhysics/SetObject3DPhysicsAngularVelocity.htm
SetObject3DPhysicsAngularVelocity|Reference/3DPhysics/SetObject3DPhysicsAngularVelocity.htm
SetObject3DPhysicsAnisotropicFriction|Reference/3DPhysics/SetObject3DPhysicsAnisotropicFriction.htm
SetObject3DPhysicsCanSleep|Reference/3DPhysics/SetObject3DPhysicsCanSleep.htm
SetObject3DPhysicsDamping|Reference/3DPhysics/SetObject3DPhysicsDamping.htm
SetObject3DPhysicsDeactivationTime|Reference/3DPhysics/SetObject3DPhysicsDeactivationTime.htm
SetObject3DPhysicsFriction|Reference/3DPhysics/SetObject3DPhysicsFriction.htm
SetObject3DPhysicsGroupAndMask|Reference/3DPhysics/SetObject3DPhysicsGroupAndMask.htm
SetObject3DPhysicsLinearVelocity|Reference/3DPhysics/SetObject3DPhysicsLinearVelocity.htm
SetObject3DPhysicsLinearVelocity|Reference/3DPhysics/SetObject3DPhysicsLinearVelocity.htm
SetObject3DPhysicsMass|Reference/3DPhysics/SetObject3DPhysicsMass.htm
SetObject3DPhysicsMaxLinearVelocity|Reference/3DPhysics/SetObject3DPhysicsMaxLinearVelocity.htm
SetObject3DPhysicsRestitution|Reference/3DPhysics/SetObject3DPhysicsRestitution.htm
SetObject3DPhysicsRollingFriction|Reference/3DPhysics/SetObject3DPhysicsRollingFriction.htm
SetObject3DPhysicsSleepingThreshold|Reference/3DPhysics/SetObject3DPhysicsSleepingThreshold.htm
DeleteMusicOGG|Reference/Music/DeleteMusicOGG.htm
GetMusicDurationOGG|Reference/Music/GetMusicDurationOGG.htm
GetMusicExistsOGG|Reference/Music/GetMusicExistsOGG.htm
GetMusicLoopCountOGG|Reference/Music/GetMusicLoopCountOGG.htm
GetMusicPlayingOGG|Reference/Music/GetMusicPlayingOGG.htm
GetMusicPositionOGG|Reference/Music/GetMusicPositionOGG.htm
LoadMusicOGG|Reference/Music/LoadMusicOGG.htm
LoadMusicOGG|Reference/Music/LoadMusicOGG.htm
PauseMusicOGG|Reference/Music/PauseMusicOGG.htm
PlayMusicOGG|Reference/Music/PlayMusicOGG.htm
PlayMusicOGG|Reference/Music/PlayMusicOGG.htm
ResumeMusicOGG|Reference/Music/ResumeMusicOGG.htm
SeekMusicOGG|Reference/Music/SeekMusicOGG.htm
SetMusicLoopCountOGG|Reference/Music/SetMusicLoopCountOGG.htm
SetMusicLoopTimesOGG|Reference/Music/SetMusicLoopTimesOGG.htm
SetMusicSystemVolumeOGG|Reference/Music/SetMusicSystemVolumeOGG.htm
SetMusicVolumeOGG|Reference/Music/SetMusicVolumeOGG.htm
StopMusicOGG|Reference/Music/StopMusicOGG.htm
GetCapturedImage|Reference/Image/GetCapturedImage.htm
GetDeviceCameraType|Reference/Image/GetDeviceCameraType.htm
GetNumDeviceCameras|Reference/Image/GetNumDeviceCameras.htm
IsCapturingImage|Reference/Image/IsCapturingImage.htm
SetDeviceCameraToImage|Reference/Image/SetDeviceCameraToImage.htm
ShowImageCaptureScreen|Reference/Image/ShowImageCaptureScreen.htm
CloseRawFolder|Reference/File/CloseRawFolder.htm
GetRawFolderFileName|Reference/File/GetRawFolderFileName.htm
GetRawFolderFolderName|Reference/File/GetRawFolderFolderName.htm
GetRawFolderNumFiles|Reference/File/GetRawFolderNumFiles.htm
GetRawFolderNumFolders|Reference/File/GetRawFolderNumFolders.htm
OpenRawFolder|Reference/File/OpenRawFolder.htm
GetObject3DPhysicsContactObjectB|Reference/3DPhysics/GetObject3DPhysicsContactObjectB.htm
GetObject3DPhysicsContactVector|Reference/3DPhysics/GetObject3DPhysicsContactVector.htm
GetObject3DPhysicsContactX|Reference/3DPhysics/GetObject3DPhysicsContactX.htm
GetObject3DPhysicsContactY|Reference/3DPhysics/GetObject3DPhysicsContactY.htm
GetObject3DPhysicsContactZ|Reference/3DPhysics/GetObject3DPhysicsContactZ.htm
GetObject3DPhysicsFirstContact|Reference/3DPhysics/GetObject3DPhysicsFirstContact.htm
GetObject3DPhysicsNextContact|Reference/3DPhysics/GetObject3DPhysicsNextContact.htm
GetObjects3DPhysicsContactPositionVector|Reference/3DPhysics/GetObjects3DPhysicsContactPositionVector.htm
GetRawMouseFifthPressed|Reference/Input-Raw/GetRawMouseFifthPressed.htm
GetRawMouseFifthReleased|Reference/Input-Raw/GetRawMouseFifthReleased.htm
GetRawMouseFifthState|Reference/Input-Raw/GetRawMouseFifthState.htm
GetRawMouseFourthPressed|Reference/Input-Raw/GetRawMouseFourthPressed.htm
GetRawMouseFourthReleased|Reference/Input-Raw/GetRawMouseFourthReleased.htm
GetRawMouseFourthState|Reference/Input-Raw/GetRawMouseFourthState.htm
GetRawMouseLeftPressed|Reference/Input-Raw/GetRawMouseLeftPressed.htm
GetRawMouseLeftReleased|Reference/Input-Raw/GetRawMouseLeftReleased.htm
GetRawMouseLeftState|Reference/Input-Raw/GetRawMouseLeftState.htm
GetRawMouseMiddlePressed|Reference/Input-Raw/GetRawMouseMiddlePressed.htm
GetRawMouseMiddleReleased|Reference/Input-Raw/GetRawMouseMiddleReleased.htm
GetRawMouseMiddleState|Reference/Input-Raw/GetRawMouseMiddleState.htm
GetRawMouseRightPressed|Reference/Input-Raw/GetRawMouseRightPressed.htm
GetRawMouseRightReleased|Reference/Input-Raw/GetRawMouseRightReleased.htm
GetRawMouseRightState|Reference/Input-Raw/GetRawMouseRightState.htm
GetRawMouseWheel|Reference/Input-Raw/GetRawMouseWheel.htm
GetRawMouseWheelDelta|Reference/Input-Raw/GetRawMouseWheelDelta.htm
GetRawMouseX|Reference/Input-Raw/GetRawMouseX.htm
GetRawMouseY|Reference/Input-Raw/GetRawMouseY.htm
SetRawMousePosition|Reference/Input-Raw/SetRawMousePosition.htm
SetRawMouseVisible|Reference/Input-Raw/SetRawMouseVisible.htm
DeleteFolder|Reference/File/DeleteFolder.htm
GetCurrentDir|Reference/File/GetCurrentDir.htm
GetFileCount|Reference/File/GetFileCount.htm
GetFileCount|Reference/File/GetFileCount.htm
GetFirstFile|Reference/File/GetFirstFile.htm
GetFirstFile|Reference/File/GetFirstFile.htm
GetFirstFolder|Reference/File/GetFirstFolder.htm
GetFirstFolder|Reference/File/GetFirstFolder.htm
GetFolder|Reference/File/GetFolder.htm
GetFolderCount|Reference/File/GetFolderCount.htm
GetFolderCount|Reference/File/GetFolderCount.htm
GetNextFile|Reference/File/GetNextFile.htm
GetNextFolder|Reference/File/GetNextFolder.htm
MakeFolder|Reference/File/MakeFolder.htm
SetCurrentDir|Reference/File/SetCurrentDir.htm
SetFolder|Reference/File/SetFolder.htm
DrawBox|Reference/Core/DrawBox.htm
DrawEllipse|Reference/Core/DrawEllipse.htm
DrawLine|Reference/Core/DrawLine.htm
DrawLine|Reference/Core/DrawLine.htm
GetColorBlue|Reference/Core/GetColorBlue.htm
GetColorGreen|Reference/Core/GetColorGreen.htm
GetColorRed|Reference/Core/GetColorRed.htm
MakeColor|Reference/Core/MakeColor.htm
ChooseRawFile|Reference/File/ChooseRawFile.htm
ChooseRawFile|Reference/File/ChooseRawFile.htm
CloseFile|Reference/File/CloseFile.htm
DeleteFile|Reference/File/DeleteFile.htm
FileIsOpen|Reference/File/FileIsOpen.htm
GetDocumentsPath|Reference/File/GetDocumentsPath.htm
GetFileExists|Reference/File/GetFileExists.htm
GetFilePos|Reference/File/GetFilePos.htm
GetFileSize|Reference/File/GetFileSize.htm
GetReadPath|Reference/File/GetReadPath.htm
GetWritePath|Reference/File/GetWritePath.htm
SetFilePos|Reference/File/SetFilePos.htm
SetRawWritePath|Reference/File/SetRawWritePath.htm
IsSoundRecording|Reference/Sound/IsSoundRecording.htm
RecordSound|Reference/Sound/RecordSound.htm
StopSoundRecording|Reference/Sound/StopSoundRecording.htm
TweenBounce|Reference/Tweening/TweenBounce.htm
TweenEaseIn1|Reference/Tweening/TweenEaseIn1.htm
TweenEaseIn2|Reference/Tweening/TweenEaseIn2.htm
TweenEaseOut1|Reference/Tweening/TweenEaseOut1.htm
TweenEaseOut2|Reference/Tweening/TweenEaseOut2.htm
TweenLinear|Reference/Tweening/TweenLinear.htm
TweenOvershoot|Reference/Tweening/TweenOvershoot.htm
TweenSmooth1|Reference/Tweening/TweenSmooth1.htm
TweenSmooth2|Reference/Tweening/TweenSmooth2.htm
ClearTweenText|Reference/Tweening/ClearTweenText.htm
CreateTweenText|Reference/Tweening/CreateTweenText.htm
CreateTweenText|Reference/Tweening/CreateTweenText.htm
GetTweenTextEndTime|Reference/Tweening/GetTweenTextEndTime.htm
GetTweenTextExists|Reference/Tweening/GetTweenTextExists.htm
GetTweenTextPlaying|Reference/Tweening/GetTweenTextPlaying.htm
GetTweenTextTime|Reference/Tweening/GetTweenTextTime.htm
PauseTweenText|Reference/Tweening/PauseTweenText.htm
PlayTweenText|Reference/Tweening/PlayTweenText.htm
ResumeTweenText|Reference/Tweening/ResumeTweenText.htm
SetTweenTextAlpha|Reference/Tweening/SetTweenTextAlpha.htm
SetTweenTextAngle|Reference/Tweening/SetTweenTextAngle.htm
SetTweenTextBlue|Reference/Tweening/SetTweenTextBlue.htm
SetTweenTextGreen|Reference/Tweening/SetTweenTextGreen.htm
SetTweenTextLineSpacing|Reference/Tweening/SetTweenTextLineSpacing.htm
SetTweenTextRed|Reference/Tweening/SetTweenTextRed.htm
SetTweenTextSize|Reference/Tweening/SetTweenTextSize.htm
SetTweenTextSpacing|Reference/Tweening/SetTweenTextSpacing.htm
SetTweenTextX|Reference/Tweening/SetTweenTextX.htm
SetTweenTextY|Reference/Tweening/SetTweenTextY.htm
StopTweenText|Reference/Tweening/StopTweenText.htm
AddNetworkMessageByte|Reference/Multiplayer/AddNetworkMessageByte.htm
AddNetworkMessageFloat|Reference/Multiplayer/AddNetworkMessageFloat.htm
AddNetworkMessageInteger|Reference/Multiplayer/AddNetworkMessageInteger.htm
AddNetworkMessageString|Reference/Multiplayer/AddNetworkMessageString.htm
CopyNetworkMessage|Reference/Multiplayer/CopyNetworkMessage.htm
CreateNetworkMessage|Reference/Multiplayer/CreateNetworkMessage.htm
DeleteNetworkMessage|Reference/Multiplayer/DeleteNetworkMessage.htm
GetNetworkMessage|Reference/Multiplayer/GetNetworkMessage.htm
GetNetworkMessageByte|Reference/Multiplayer/GetNetworkMessageByte.htm
GetNetworkMessageFloat|Reference/Multiplayer/GetNetworkMessageFloat.htm
GetNetworkMessageFromClient|Reference/Multiplayer/GetNetworkMessageFromClient.htm
GetNetworkMessageFromIP|Reference/Multiplayer/GetNetworkMessageFromIP.htm
GetNetworkMessageFromPort|Reference/Multiplayer/GetNetworkMessageFromPort.htm
GetNetworkMessageInteger|Reference/Multiplayer/GetNetworkMessageInteger.htm
GetNetworkMessageString|Reference/Multiplayer/GetNetworkMessageString.htm
SendNetworkMessage|Reference/Multiplayer/SendNetworkMessage.htm
GetAccelerometerExists|Reference/Input-Raw/GetAccelerometerExists.htm
GetCameraExists|Reference/Input-Raw/GetCameraExists.htm
GetGPSSensorExists|Reference/Input-Raw/GetGPSSensorExists.htm
GetGyroSensorExists|Reference/Input-Raw/GetGyroSensorExists.htm
GetJoystickExists|Reference/Input-Raw/GetJoystickExists.htm
GetKeyboardExists|Reference/Input-Raw/GetKeyboardExists.htm
GetLightSensorExists|Reference/Input-Raw/GetLightSensorExists.htm
GetMagneticSensorExists|Reference/Input-Raw/GetMagneticSensorExists.htm
GetMouseExists|Reference/Input-Raw/GetMouseExists.htm
GetMultiTouchExists|Reference/Input-Raw/GetMultiTouchExists.htm
GetNFCExists|Reference/Input-Raw/GetNFCExists.htm
GetProximitySensorExists|Reference/Input-Raw/GetProximitySensorExists.htm
GetRotationVectorSensorExists|Reference/Input-Raw/GetRotationVectorSensorExists.htm
GetPushNotificationToken|Reference/Extras/GetPushNotificationToken.htm
PushNotificationSetup|Reference/Extras/PushNotificationSetup.htm
SetPushNotificationKeys|Reference/Extras/SetPushNotificationKeys.htm
Print|Reference/Text/Print.htm
Print|Reference/Text/Print.htm
Print|Reference/Text/Print.htm
PrintC|Reference/Text/PrintC.htm
PrintC|Reference/Text/PrintC.htm
PrintC|Reference/Text/PrintC.htm
SetPrintColor|Reference/Text/SetPrintColor.htm
SetPrintColor|Reference/Text/SetPrintColor.htm
SetPrintFont|Reference/Text/SetPrintFont.htm
SetPrintSize|Reference/Text/SetPrintSize.htm
SetPrintSpacing|Reference/Text/SetPrintSpacing.htm
AddVirtualButton|Reference/Input/AddVirtualButton.htm
DeleteVirtualButton|Reference/Input/DeleteVirtualButton.htm
GetVirtualButtonExists|Reference/Input/GetVirtualButtonExists.htm
GetVirtualButtonPressed|Reference/Input/GetVirtualButtonPressed.htm
GetVirtualButtonReleased|Reference/Input/GetVirtualButtonReleased.htm
GetVirtualButtonState|Reference/Input/GetVirtualButtonState.htm
SetVirtualButtonActive|Reference/Input/SetVirtualButtonActive.htm
SetVirtualButtonAlpha|Reference/Input/SetVirtualButtonAlpha.htm
SetVirtualButtonColor|Reference/Input/SetVirtualButtonColor.htm
SetVirtualButtonImageDown|Reference/Input/SetVirtualButtonImageDown.htm
SetVirtualButtonImageUp|Reference/Input/SetVirtualButtonImageUp.htm
SetVirtualButtonPosition|Reference/Input/SetVirtualButtonPosition.htm
SetVirtualButtonSize|Reference/Input/SetVirtualButtonSize.htm
SetVirtualButtonSize|Reference/Input/SetVirtualButtonSize.htm
SetVirtualButtonText|Reference/Input/SetVirtualButtonText.htm
SetVirtualButtonVisible|Reference/Input/SetVirtualButtonVisible.htm
GetCharBuffer|Reference/Input-Raw/GetCharBuffer.htm
GetCharBufferLength|Reference/Input-Raw/GetCharBufferLength.htm
GetRawKeyPressed|Reference/Input-Raw/GetRawKeyPressed.htm
GetRawKeyReleased|Reference/Input-Raw/GetRawKeyReleased.htm
GetRawKeyState|Reference/Input-Raw/GetRawKeyState.htm
GetRawLastKey|Reference/Input-Raw/GetRawLastKey.htm
AddHTTPHeader|Reference/HTTP/AddHTTPHeader.htm
CloseHTTPConnection|Reference/HTTP/CloseHTTPConnection.htm
CreateHTTPConnection|Reference/HTTP/CreateHTTPConnection.htm
DeleteHTTPConnection|Reference/HTTP/DeleteHTTPConnection.htm
GetHTTPFile|Reference/HTTP/GetHTTPFile.htm
GetHTTPFile|Reference/HTTP/GetHTTPFile.htm
GetHTTPFileComplete|Reference/HTTP/GetHTTPFileComplete.htm
GetHTTPFileProgress|Reference/HTTP/GetHTTPFileProgress.htm
GetHTTPResponse|Reference/HTTP/GetHTTPResponse.htm
GetHTTPResponseReady|Reference/HTTP/GetHTTPResponseReady.htm
GetHTTPStatusCode|Reference/HTTP/GetHTTPStatusCode.htm
GetInternetState|Reference/HTTP/GetInternetState.htm
OpenBrowser|Reference/HTTP/OpenBrowser.htm
RemoveHTTPHeader|Reference/HTTP/RemoveHTTPHeader.htm
SendHTTPFile|Reference/HTTP/SendHTTPFile.htm
SendHTTPRequest|Reference/HTTP/SendHTTPRequest.htm
SendHTTPRequest|Reference/HTTP/SendHTTPRequest.htm
SendHTTPRequestASync|Reference/HTTP/SendHTTPRequestASync.htm
SendHTTPRequestASync|Reference/HTTP/SendHTTPRequestASync.htm
SetHTTPHost|Reference/HTTP/SetHTTPHost.htm
SetHTTPHost|Reference/HTTP/SetHTTPHost.htm
SetHTTPTimeout|Reference/HTTP/SetHTTPTimeout.htm
SetHTTPVerifyCertificate|Reference/HTTP/SetHTTPVerifyCertificate.htm
DeleteCloudDataVariable|Reference/Extras/DeleteCloudDataVariable.htm
GetCloudDataAllowed|Reference/Extras/GetCloudDataAllowed.htm
GetCloudDataChanged|Reference/Extras/GetCloudDataChanged.htm
GetCloudDataVariable|Reference/Extras/GetCloudDataVariable.htm
SetCloudDataVariable|Reference/Extras/SetCloudDataVariable.htm
SetupCloudData|Reference/Extras/SetupCloudData.htm
ShowFullscreenAdvertAmazon|Reference/Advert/ShowFullscreenAdvertAmazon.htm
GetClipboardText|Reference/Extras/GetClipboardText.htm
SetClipboardText|Reference/Extras/SetClipboardText.htm
DeleteMusic|Reference/Music/DeleteMusic.htm
GetMusicDuration|Reference/Music/GetMusicDuration.htm
GetMusicExists|Reference/Music/GetMusicExists.htm
GetMusicPlaying|Reference/Music/GetMusicPlaying.htm
GetMusicPosition|Reference/Music/GetMusicPosition.htm
LoadMusic|Reference/Music/LoadMusic.htm
LoadMusic|Reference/Music/LoadMusic.htm
PauseMusic|Reference/Music/PauseMusic.htm
PlayMusic|Reference/Music/PlayMusic.htm
PlayMusic|Reference/Music/PlayMusic.htm
PlayMusic|Reference/Music/PlayMusic.htm
PlayMusic|Reference/Music/PlayMusic.htm
ResumeMusic|Reference/Music/ResumeMusic.htm
SeekMusic|Reference/Music/SeekMusic.htm
SetMusicFileVolume|Reference/Music/SetMusicFileVolume.htm
SetMusicSystemVolume|Reference/Music/SetMusicSystemVolume.htm
StopMusic|Reference/Music/StopMusic.htm
GetFogMode|Reference/3D/GetFogMode.htm
SetFogColor|Reference/3D/SetFogColor.htm
SetFogMode|Reference/3D/SetFogMode.htm
SetFogRange|Reference/3D/SetFogRange.htm
SetFogSunColor|Reference/3D/SetFogSunColor.htm
CreateSocketListener|Reference/Multiplayer/CreateSocketListener.htm
CreateSocketListener|Reference/Multiplayer/CreateSocketListener.htm
DeleteSocketListener|Reference/Multiplayer/DeleteSocketListener.htm
GetSocketListenerConnection|Reference/Multiplayer/GetSocketListenerConnection.htm
DecodeQRCode|Reference/Image/DecodeQRCode.htm
EncodeQRCode|Reference/Image/EncodeQRCode.htm
VibrateDevice|Reference/Sound/VibrateDevice.htm
ResizeImage|Reference/Image/ResizeImage.htm
SetImageMask|Reference/Image/SetImageMask.htm
SetImageTransparentColor|Reference/Image/SetImageTransparentColor.htm
ClearTweenObject|Reference/Tweening/ClearTweenObject.htm
ClearTweenSprite|Reference/Tweening/ClearTweenSprite.htm
CreateTweenSprite|Reference/Tweening/CreateTweenSprite.htm
CreateTweenSprite|Reference/Tweening/CreateTweenSprite.htm
GetTweenSpriteEndTime|Reference/Tweening/GetTweenSpriteEndTime.htm
GetTweenSpriteExists|Reference/Tweening/GetTweenSpriteExists.htm
GetTweenSpritePlaying|Reference/Tweening/GetTweenSpritePlaying.htm
GetTweenSpriteTime|Reference/Tweening/GetTweenSpriteTime.htm
PauseTweenSprite|Reference/Tweening/PauseTweenSprite.htm
PlayTweenSprite|Reference/Tweening/PlayTweenSprite.htm
ResumeTweenSprite|Reference/Tweening/ResumeTweenSprite.htm
SetTweenSpriteAlpha|Reference/Tweening/SetTweenSpriteAlpha.htm
SetTweenSpriteAngle|Reference/Tweening/SetTweenSpriteAngle.htm
SetTweenSpriteBlue|Reference/Tweening/SetTweenSpriteBlue.htm
SetTweenSpriteGreen|Reference/Tweening/SetTweenSpriteGreen.htm
SetTweenSpriteRed|Reference/Tweening/SetTweenSpriteRed.htm
SetTweenSpriteSizeX|Reference/Tweening/SetTweenSpriteSizeX.htm
SetTweenSpriteSizeY|Reference/Tweening/SetTweenSpriteSizeY.htm
SetTweenSpriteX|Reference/Tweening/SetTweenSpriteX.htm
SetTweenSpriteXByOffset|Reference/Tweening/SetTweenSpriteXByOffset.htm
SetTweenSpriteY|Reference/Tweening/SetTweenSpriteY.htm
SetTweenSpriteYByOffset|Reference/Tweening/SetTweenSpriteYByOffset.htm
StopTweenSprite|Reference/Tweening/StopTweenSprite.htm
GetFractalX|Reference/Core/GetFractalX.htm
GetFractalXY|Reference/Core/GetFractalXY.htm
GetFractalXYZ|Reference/Core/GetFractalXYZ.htm
GetNoiseX|Reference/Core/GetNoiseX.htm
GetNoiseXY|Reference/Core/GetNoiseXY.htm
GetNoiseXYZ|Reference/Core/GetNoiseXYZ.htm
SetupNoise|Reference/Core/SetupNoise.htm
CloneSprite|Reference/Sprite/CloneSprite.htm
CloneSprite|Reference/Sprite/CloneSprite.htm
CreateDummySprite|Reference/Sprite/CreateDummySprite.htm
CreateDummySprite|Reference/Sprite/CreateDummySprite.htm
CreateSprite|Reference/Sprite/CreateSprite.htm
CreateSprite|Reference/Sprite/CreateSprite.htm
DeleteAllSprites|Reference/Sprite/DeleteAllSprites.htm
DeleteSprite|Reference/Sprite/DeleteSprite.htm
LoadSprite|Reference/Sprite/LoadSprite.htm
LoadSprite|Reference/Sprite/LoadSprite.htm
GetSoundExists|Reference/Sound/GetSoundExists.htm
GetSoundInstanceLoopCount|Reference/Sound/GetSoundInstanceLoopCount.htm
GetSoundInstancePlaying|Reference/Sound/GetSoundInstancePlaying.htm
GetSoundInstanceRate|Reference/Sound/GetSoundInstanceRate.htm
GetSoundInstanceVolume|Reference/Sound/GetSoundInstanceVolume.htm
GetSoundInstances|Reference/Sound/GetSoundInstances.htm
GetSoundMaxRate|Reference/Sound/GetSoundMaxRate.htm
GetSoundMinRate|Reference/Sound/GetSoundMinRate.htm
GetSoundsPlaying|Reference/Sound/GetSoundsPlaying.htm
SetSoundInstanceBalance|Reference/Sound/SetSoundInstanceBalance.htm
SetSoundInstanceRate|Reference/Sound/SetSoundInstanceRate.htm
SetSoundInstanceVolume|Reference/Sound/SetSoundInstanceVolume.htm
SetSoundSystemVolume|Reference/Sound/SetSoundSystemVolume.htm
StopSoundInstance|Reference/Sound/StopSoundInstance.htm
